Action,Quantity,Price,Time,Portfolio Value,Remaining Balance
Buy,386,2588.52,2021-10-06 00:00:00,999168.72,831.2800000000279
Sell,386,2586.87,2021-10-06 00:15:00,998531.82,999363.1
Buy,382,2613.15,2021-10-06 01:15:00,998223.3,1139.7999999999302
Sell,382,2584.05,2021-10-06 01:30:00,987107.1000000001,988246.9
Buy,382,2584.05,2021-10-06 01:30:00,987107.1000000001,1139.7999999999302
Sell,382,2569.47,2021-10-06 01:45:00,981537.5399999999,982677.3399999999
Buy,379,2586.91,2021-10-06 03:00:00,980438.8899999999,2238.4499999999534
Sell,379,2578.52,2021-10-06 03:15:00,977259.08,979497.5299999999
Buy,379,2578.52,2021-10-06 03:15:00,977259.08,2238.4499999999534
Sell,379,2567.98,2021-10-06 03:30:00,973264.42,975502.87
Buy,373,2613.15,2021-10-06 04:00:00,974704.9500000001,797.9199999999255
Sell,373,2557.5,2021-10-06 04:15:00,953947.5,954745.4199999999
Buy,374,2551.66,2021-10-06 05:00:00,954320.84,424.5799999999581
Sell,374,2530.35,2021-10-06 05:15:00,946350.9,946775.48
Buy,374,2530.35,2021-10-06 05:15:00,946350.9,424.5799999999581
Sell,374,2533.32,2021-10-06 05:30:00,947461.68,947886.26
Buy,373,2536.79,2021-10-06 05:45:00,946222.67,1663.5899999999674
Sell,373,2526.55,2021-10-06 06:00:00,942403.15,944066.74
Buy,372,2533.08,2021-10-06 06:30:00,942305.76,1760.9799999999814
Sell,372,2539.45,2021-10-06 06:45:00,944675.3999999999,946436.3799999999
Buy,371,2547.04,2021-10-06 07:00:00,944951.84,1484.5399999999208
Sell,371,2543.97,2021-10-06 07:15:00,943812.8699999999,945297.4099999998
Buy,371,2543.97,2021-10-06 07:15:00,943812.8699999999,1484.5399999999208
Sell,371,2539.69,2021-10-06 07:30:00,942224.99,943709.5299999999
Buy,370,2547.14,2021-10-06 07:45:00,942441.7999999999,1267.7299999999814
Sell,370,2542.92,2021-10-06 08:00:00,940880.4,942148.13
Buy,370,2542.92,2021-10-06 08:00:00,940880.4,1267.7299999999814
Sell,370,2539.65,2021-10-06 08:15:00,939670.5,940938.23
Buy,370,2539.65,2021-10-06 08:15:00,939670.5,1267.7299999999814
Sell,370,2515.51,2021-10-06 08:30:00,930738.7000000001,932006.43
Buy,370,2515.51,2021-10-06 08:30:00,930738.7000000001,1267.7299999999814
Sell,370,2511.87,2021-10-06 08:45:00,929391.8999999999,930659.6299999999
Buy,370,2511.87,2021-10-06 08:45:00,929391.8999999999,1267.7299999999814
Sell,370,2499.59,2021-10-06 09:00:00,924848.3,926116.03
Buy,356,2597.91,2021-10-06 10:15:00,924855.96,1260.0700000000652
Sell,356,2589.96,2021-10-06 10:30:00,922025.76,923285.8300000001
Buy,356,2589.96,2021-10-06 10:30:00,922025.76,1260.0700000000652
Sell,356,2575.99,2021-10-06 10:45:00,917052.44,918312.51
Buy,356,2575.99,2021-10-06 10:45:00,917052.44,1260.0700000000652
Sell,356,2580.83,2021-10-06 11:00:00,918775.48,920035.55
Buy,356,2580.83,2021-10-06 11:00:00,918775.48,1260.0700000000652
Sell,356,2566.84,2021-10-06 11:15:00,913795.04,915055.1100000001
Buy,356,2566.84,2021-10-06 11:15:00,913795.04,1260.0700000000652
Sell,356,2569.57,2021-10-06 11:30:00,914766.92,916026.9900000001
Buy,356,2569.57,2021-10-06 11:30:00,914766.92,1260.0700000000652
Sell,356,2565.25,2021-10-06 11:45:00,913229.0,914489.0700000001
Buy,356,2565.25,2021-10-06 11:45:00,913229.0,1260.0700000000652
Sell,356,2554.22,2021-10-06 12:00:00,909302.32,910562.39
Buy,356,2554.22,2021-10-06 12:00:00,909302.32,1260.0700000000652
Sell,356,2534.99,2021-10-06 12:15:00,902456.44,903716.51
Buy,353,2555.94,2021-10-06 12:45:00,902246.8200000001,1469.6899999999441
Sell,353,2534.5,2021-10-06 13:15:00,894678.5,896148.19
Buy,353,2534.5,2021-10-06 13:15:00,894678.5,1469.6899999999441
Sell,353,2536.67,2021-10-06 13:30:00,895444.51,896914.2
Buy,352,2544.1,2021-10-06 13:45:00,895523.2,1391.0
Sell,352,2531.72,2021-10-06 14:00:00,891165.44,892556.44
Buy,352,2531.72,2021-10-06 14:00:00,891165.44,1391.0
Sell,352,2521.19,2021-10-06 14:15:00,887458.88,888849.88
Buy,352,2521.19,2021-10-06 14:15:00,887458.88,1391.0
Sell,352,2515.55,2021-10-06 14:30:00,885473.6000000001,886864.6000000001
Buy,351,2521.63,2021-10-06 14:45:00,885092.13,1772.4700000000885
Sell,351,2518.0,2021-10-06 15:00:00,883818.0,885590.4700000001
Buy,351,2518.0,2021-10-06 15:00:00,883818.0,1772.4700000000885
Sell,351,2511.75,2021-10-06 15:45:00,881624.25,883396.7200000001
Buy,351,2511.75,2021-10-06 15:45:00,881624.25,1772.4700000000885
Sell,351,2489.73,2021-10-06 16:00:00,873895.23,875667.7000000001
Buy,351,2489.73,2021-10-06 16:00:00,873895.23,1772.4700000000885
Sell,351,2480.77,2021-10-06 16:15:00,870750.27,872522.7400000001
Buy,333,2613.15,2021-10-06 16:30:00,870178.9500000001,2343.7900000000373
Sell,333,2479.62,2021-10-06 16:45:00,825713.46,828057.25
Buy,333,2479.62,2021-10-06 16:45:00,825713.46,2343.7900000000373
Sell,333,2459.34,2021-10-06 17:00:00,818960.2200000001,821304.0100000001
Buy,314,2613.15,2021-10-06 18:00:00,820529.1,774.910000000149
Sell,314,2470.5,2021-10-06 18:15:00,775737.0,776511.9100000001
Buy,314,2470.5,2021-10-06 18:15:00,775737.0,774.910000000149
Sell,314,2468.95,2021-10-06 18:30:00,775250.2999999999,776025.2100000001
Buy,313,2473.04,2021-10-06 18:45:00,774061.52,1963.6900000000605
Sell,313,2463.43,2021-10-06 19:00:00,771053.59,773017.28
Buy,313,2463.43,2021-10-06 19:00:00,771053.59,1963.6900000000605
Sell,313,2454.65,2021-10-06 19:15:00,768305.4500000001,770269.1400000001
Buy,312,2467.98,2021-10-06 19:30:00,770009.76,259.3800000001211
Sell,312,2439.59,2021-10-06 20:00:00,761152.0800000001,761411.4600000002
Buy,312,2439.59,2021-10-06 20:00:00,761152.0800000001,259.3800000001211
Sell,312,2443.29,2021-10-06 20:15:00,762306.48,762565.8600000001
Buy,307,2476.89,2021-10-06 21:30:00,760405.23,2160.630000000121
Sell,307,2482.27,2021-10-06 21:45:00,762056.89,764217.5200000001
Buy,307,2489.1,2021-10-06 22:00:00,764153.7,63.82000000018161
Sell,307,2478.28,2021-10-06 22:30:00,760831.9600000001,760895.7800000003
Buy,306,2485.62,2021-10-06 23:00:00,760599.72,296.0600000002887
Sell,306,2483.96,2021-10-06 23:15:00,760091.76,760387.8200000003
Buy,306,2484.06,2021-10-06 23:30:00,760122.36,265.460000000312
Sell,306,2471.11,2021-10-06 23:45:00,756159.66,756425.1200000003
Buy,306,2471.11,2021-10-06 23:45:00,756159.66,265.460000000312
Sell,306,2164.31,2021-10-07 00:00:00,662278.86,662544.3200000003
Buy,307,2157.26,2021-10-07 01:15:00,662278.8200000001,265.50000000023283
Sell,307,1925.49,2021-10-07 01:30:00,591125.43,591390.9300000003
Buy,276,2135.76,2021-10-07 02:45:00,589469.76,1921.1700000002747
Sell,276,2141.9,2021-10-07 03:00:00,591164.4,593085.5700000003
Buy,278,2126.73,2021-10-07 04:30:00,591230.9400000001,1854.6300000002375
Sell,278,2107.29,2021-10-07 04:45:00,585826.62,587681.2500000002
Buy,278,2113.44,2021-10-07 05:00:00,587536.3200000001,144.93000000016764
Sell,278,2111.09,2021-10-07 05:15:00,586883.02,587027.9500000002
Buy,278,2111.09,2021-10-07 05:15:00,586883.02,144.93000000016764
Sell,278,2117.82,2021-10-07 05:30:00,588753.9600000001,588898.8900000002
Buy,277,2122.74,2021-10-07 06:15:00,587998.98,899.9100000002654
Sell,277,2117.3,2021-10-07 06:30:00,586492.1000000001,587392.0100000004
Buy,275,2132.4,2021-10-07 06:45:00,586410.0,982.0100000003586
Sell,275,2114.16,2021-10-07 07:00:00,581394.0,582376.0100000004
Buy,275,2114.16,2021-10-07 07:00:00,581394.0,982.0100000003586
Sell,275,2113.69,2021-10-07 07:15:00,581264.75,582246.7600000004
Buy,275,2117.26,2021-10-07 07:30:00,582246.5000000001,0.26000000024214387
Sell,275,2121.7,2021-10-07 07:45:00,583467.5,583467.7600000002
Buy,274,2125.32,2021-10-07 08:00:00,582337.68,1130.080000000191
Sell,274,2127.89,2021-10-07 08:15:00,583041.86,584171.9400000002
Buy,274,2127.89,2021-10-07 08:15:00,583041.86,1130.080000000191
Sell,274,2125.45,2021-10-07 08:30:00,582373.2999999999,583503.3800000001
Buy,274,2125.45,2021-10-07 08:30:00,582373.2999999999,1130.080000000191
Sell,274,2121.35,2021-10-07 08:45:00,581249.9,582379.9800000002
Buy,274,2121.35,2021-10-07 08:45:00,581249.9,1130.080000000191
Sell,274,2125.36,2021-10-07 09:00:00,582348.64,583478.7200000002
Buy,273,2129.53,2021-10-07 09:30:00,581361.6900000001,2117.0300000001444
Sell,273,2117.99,2021-10-07 09:45:00,578211.2699999999,580328.3
Buy,273,2117.99,2021-10-07 09:45:00,578211.2699999999,2117.0300000001444
Sell,273,2118.52,2021-10-07 10:00:00,578355.96,580472.9900000001
Buy,273,2118.52,2021-10-07 10:00:00,578355.96,2117.0300000001444
Sell,273,2108.85,2021-10-07 10:15:00,575716.0499999999,577833.0800000001
Buy,274,2108.85,2021-10-07 10:15:00,577824.9,8.180000000051223
Sell,274,2101.46,2021-10-07 10:30:00,575800.04,575808.2200000001
Buy,274,2101.46,2021-10-07 10:30:00,575800.04,8.180000000051223
Sell,274,2090.63,2021-10-07 10:45:00,572832.62,572840.8
Buy,270,2118.02,2021-10-07 11:30:00,571865.4,975.4000000000233
Sell,270,2109.35,2021-10-07 11:45:00,569524.5,570499.9
Buy,269,2113.17,2021-10-07 12:00:00,568442.73,2057.170000000042
Sell,269,2108.78,2021-10-07 12:15:00,567261.8200000001,569318.9900000001
Buy,269,2108.78,2021-10-07 12:15:00,567261.8200000001,2057.170000000042
Sell,269,2115.5,2021-10-07 12:30:00,569069.5,571126.67
Buy,269,2117.21,2021-10-07 12:45:00,569529.49,1597.1800000000512
Sell,269,2113.41,2021-10-07 13:00:00,568507.2899999999,570104.47
Buy,269,2113.41,2021-10-07 13:00:00,568507.2899999999,1597.1800000000512
Sell,269,2108.92,2021-10-07 13:15:00,567299.48,568896.66
Buy,269,2108.92,2021-10-07 13:15:00,567299.48,1597.1800000000512
Sell,269,2100.4,2021-10-07 13:30:00,565007.6,566604.78
Buy,269,2100.4,2021-10-07 13:30:00,565007.6,1597.1800000000512
Sell,269,2099.65,2021-10-07 13:45:00,564805.85,566403.03
Buy,269,2099.65,2021-10-07 13:45:00,564805.85,1597.1800000000512
Sell,269,2097.35,2021-10-07 14:00:00,564187.15,565784.3300000001
Buy,267,2111.53,2021-10-07 14:45:00,563778.51,2005.8200000000652
Sell,267,2111.01,2021-10-07 15:00:00,563639.67,565645.4900000001
Buy,266,2121.19,2021-10-07 15:30:00,564236.54,1408.9500000000698
Sell,266,2118.5,2021-10-07 15:45:00,563521.0,564929.9500000001
Buy,266,2118.5,2021-10-07 15:45:00,563521.0,1408.9500000000698
Sell,266,2117.78,2021-10-07 16:00:00,563329.4800000001,564738.4300000002
Buy,263,2144.15,2021-10-07 16:30:00,563911.4500000001,826.9800000000978
Sell,263,2134.23,2021-10-07 16:45:00,561302.49,562129.4700000001
Buy,263,2134.23,2021-10-07 16:45:00,561302.49,826.9800000000978
Sell,263,2100.32,2021-10-07 17:00:00,552384.16,553211.1400000001
Buy,263,2100.32,2021-10-07 17:00:00,552384.16,826.9800000000978
Sell,263,2088.44,2021-10-07 17:15:00,549259.72,550086.7000000001
Buy,263,2088.48,2021-10-07 17:30:00,549270.24,816.4600000000792
Sell,263,2085.02,2021-10-07 17:45:00,548360.26,549176.7200000001
Buy,263,2085.02,2021-10-07 17:45:00,548360.26,816.4600000000792
Sell,263,2082.68,2021-10-07 18:00:00,547744.84,548561.3
Buy,261,2097.55,2021-10-07 19:00:00,547460.55,1100.75
Sell,261,2094.26,2021-10-07 19:15:00,546601.8600000001,547702.6100000001
Buy,261,2093.14,2021-10-07 19:45:00,546309.5399999999,1393.0700000001816
Sell,261,2086.59,2021-10-07 20:00:00,544599.99,545993.0600000002
Buy,260,2092.53,2021-10-07 20:15:00,544057.8,1935.2600000001257
Sell,260,2086.58,2021-10-07 20:30:00,542510.7999999999,544446.06
Buy,257,2112.97,2021-10-07 22:00:00,543033.2899999999,1412.770000000135
Sell,257,2106.59,2021-10-07 22:15:00,541393.63,542806.4000000001
Buy,255,2120.36,2021-10-07 23:15:00,540691.8,2114.600000000093
Sell,255,2118.53,2021-10-07 23:30:00,540225.15,542339.7500000001
Buy,172,3140.83,2021-10-08 00:00:00,540222.76,2116.990000000107
Sell,172,3157.11,2021-10-08 00:15:00,543022.92,545139.9100000001
Buy,172,3157.11,2021-10-08 00:15:00,543022.92,2116.990000000107
Sell,172,3122.31,2021-10-08 00:30:00,537037.32,539154.31
Buy,172,3125.43,2021-10-08 00:45:00,537573.96,1580.3500000000931
Sell,172,3105.02,2021-10-08 01:00:00,534063.44,535643.79
Buy,172,3105.02,2021-10-08 01:00:00,534063.44,1580.3500000000931
Sell,172,3117.56,2021-10-08 01:15:00,536220.32,537800.67
Buy,172,3117.56,2021-10-08 01:15:00,536220.32,1580.3500000000931
Sell,172,3126.91,2021-10-08 01:30:00,537828.52,539408.8700000001
Buy,172,3126.91,2021-10-08 01:30:00,537828.52,1580.3500000000931
Sell,172,3134.25,2021-10-08 01:45:00,539091.0,540671.3500000001
Buy,172,3134.25,2021-10-08 01:45:00,539091.0,1580.3500000000931
Sell,172,3130.19,2021-10-08 02:00:00,538392.68,539973.0300000001
Buy,172,3130.19,2021-10-08 02:00:00,538392.68,1580.3500000000931
Sell,172,3137.7,2021-10-08 02:15:00,539684.4,541264.7500000001
Buy,172,3137.7,2021-10-08 02:15:00,539684.4,1580.3500000000931
Sell,172,3135.33,2021-10-08 02:30:00,539276.76,540857.1100000001
Buy,172,3135.33,2021-10-08 02:30:00,539276.76,1580.3500000000931
Sell,172,3144.55,2021-10-08 02:45:00,540862.6,542442.9500000001
Buy,172,3144.55,2021-10-08 02:45:00,540862.6,1580.3500000000931
Sell,172,3132.75,2021-10-08 03:00:00,538833.0,540413.3500000001
Buy,172,3132.75,2021-10-08 03:00:00,538833.0,1580.3500000000931
Sell,172,3120.19,2021-10-08 03:15:00,536672.68,538253.0300000001
Buy,172,3125.09,2021-10-08 03:30:00,537515.48,737.550000000163
Sell,172,3117.56,2021-10-08 03:45:00,536220.32,536957.8700000001
Buy,171,3125.65,2021-10-08 04:15:00,534486.15,2471.7200000000885
Sell,171,3107.25,2021-10-08 04:30:00,531339.75,533811.4700000001
Buy,171,3107.25,2021-10-08 04:30:00,531339.75,2471.7200000000885
Sell,171,3100.59,2021-10-08 04:45:00,530200.89,532672.6100000001
Buy,171,3114.0,2021-10-08 05:45:00,532494.0,178.61000000010245
Sell,171,3110.06,2021-10-08 06:00:00,531820.26,531998.8700000001
Buy,170,3124.11,2021-10-08 06:45:00,531098.7000000001,900.1700000000419
Sell,170,3107.4,2021-10-08 07:00:00,528258.0,529158.17
Buy,168,3144.57,2021-10-08 07:45:00,528287.76,870.4100000000326
Sell,168,3136.99,2021-10-08 08:00:00,527014.32,527884.73
Buy,166,3165.3,2021-10-08 09:00:00,525439.8,2444.929999999935
Sell,166,3148.19,2021-10-08 09:15:00,522599.54000000004,525044.47
Buy,166,3148.19,2021-10-08 09:15:00,522599.54000000004,2444.929999999935
Sell,166,3146.71,2021-10-08 09:30:00,522353.86,524798.7899999999
Buy,166,3146.82,2021-10-08 09:45:00,522372.12000000005,2426.6699999998673
Sell,166,3141.19,2021-10-08 10:00:00,521437.54000000004,523864.2099999999
Buy,166,3141.19,2021-10-08 10:00:00,521437.54000000004,2426.6699999998673
Sell,166,3128.42,2021-10-08 10:15:00,519317.72000000003,521744.3899999999
Buy,166,3128.42,2021-10-08 10:15:00,519317.72000000003,2426.6699999998673
Sell,166,3120.7,2021-10-08 10:30:00,518036.19999999995,520462.8699999998
Buy,165,3153.55,2021-10-08 11:15:00,520335.75000000006,127.11999999976251
Sell,165,3124.13,2021-10-08 11:30:00,515481.45,515608.5699999998
Buy,165,3124.13,2021-10-08 11:30:00,515481.45,127.11999999976251
Sell,165,3124.71,2021-10-08 11:45:00,515577.15,515704.2699999998
Buy,161,3183.72,2021-10-08 12:45:00,512578.92,3125.349999999802
Sell,161,3189.49,2021-10-08 13:00:00,513507.88999999996,516633.23999999976
Buy,161,3189.49,2021-10-08 13:00:00,513507.88999999996,3125.349999999802
Sell,161,3193.99,2021-10-08 13:15:00,514232.38999999996,517357.73999999976
Buy,161,3193.99,2021-10-08 13:15:00,514232.38999999996,3125.349999999802
Sell,161,3161.48,2021-10-08 13:30:00,508998.28,512123.62999999983
Buy,161,3161.48,2021-10-08 13:30:00,508998.28,3125.349999999802
Sell,161,3165.0,2021-10-08 13:45:00,509565.0,512690.3499999998
Buy,161,3169.7,2021-10-08 14:00:00,510321.69999999995,2368.6499999998487
Sell,161,3153.19,2021-10-08 14:15:00,507663.59,510032.2399999999
Buy,161,3153.19,2021-10-08 14:15:00,507663.59,2368.6499999998487
Sell,161,3134.14,2021-10-08 14:30:00,504596.54,506965.1899999998
Buy,161,3145.02,2021-10-08 15:00:00,506348.22,616.9699999998556
Sell,161,3113.38,2021-10-08 15:15:00,501254.18,501871.14999999985
Buy,160,3123.24,2021-10-08 15:45:00,499718.39999999997,2152.7499999998836
Sell,160,3111.18,2021-10-08 16:00:00,497788.8,499941.5499999999
Buy,160,3111.18,2021-10-08 16:00:00,497788.8,2152.7499999998836
Sell,160,3074.25,2021-10-08 16:15:00,491880.0,494032.7499999999
Buy,159,3098.55,2021-10-08 17:15:00,492669.45,1363.299999999872
Sell,159,3089.19,2021-10-08 17:30:00,491181.21,492544.5099999999
Buy,158,3103.62,2021-10-08 17:45:00,490371.95999999996,2172.54999999993
Sell,158,3100.99,2021-10-08 18:00:00,489956.42,492128.9699999999
Buy,158,3100.99,2021-10-08 18:00:00,489956.42,2172.54999999993
Sell,158,3101.75,2021-10-08 18:15:00,490076.5,492249.04999999993
Buy,157,3132.28,2021-10-08 19:00:00,491767.96,481.0899999999092
Sell,157,3130.05,2021-10-08 19:15:00,491417.85000000003,491898.93999999994
Buy,156,3145.97,2021-10-08 19:45:00,490771.31999999995,1127.6199999999953
Sell,156,3141.09,2021-10-08 20:00:00,490010.04000000004,491137.66000000003
Buy,155,3160.54,2021-10-08 20:45:00,489883.7,1253.960000000021
Sell,155,3158.79,2021-10-08 21:00:00,489612.45,490866.41000000003
Buy,154,3183.91,2021-10-08 21:30:00,490322.13999999996,544.2700000000768
Sell,154,3171.51,2021-10-08 21:45:00,488412.54000000004,488956.8100000001
Buy,153,3190.8,2021-10-08 22:00:00,488192.4,764.4100000000908
Sell,153,3165.46,2021-10-08 22:15:00,484315.38,485079.7900000001
Buy,153,3165.46,2021-10-08 22:15:00,484315.38,764.4100000000908
Sell,153,3162.99,2021-10-08 22:30:00,483937.47,484701.88000000006
Buy,153,3153.18,2021-10-08 22:45:00,482436.54,2265.340000000084
Sell,153,3149.85,2021-10-08 23:00:00,481927.05,484192.3900000001
Buy,153,3149.85,2021-10-08 23:00:00,481927.05,2265.340000000084
Sell,153,3125.46,2021-10-08 23:15:00,478195.38,480460.7200000001
Buy,140,3417.5,2021-10-09 00:00:00,478450.0,2010.7200000000885
Sell,140,3447.98,2021-10-09 00:15:00,482717.2,484727.9200000001
Buy,140,3447.98,2021-10-09 00:15:00,482717.2,2010.7200000000885
Sell,140,3460.27,2021-10-09 00:30:00,484437.8,486448.5200000001
Buy,140,3460.27,2021-10-09 00:30:00,484437.8,2010.7200000000885
Sell,140,3453.17,2021-10-09 00:45:00,483443.8,485454.5200000001
Buy,140,3453.17,2021-10-09 00:45:00,483443.8,2010.7200000000885
Sell,140,3459.12,2021-10-09 01:00:00,484276.8,486287.5200000001
Buy,139,3476.35,2021-10-09 01:15:00,483212.64999999997,3074.8700000001118
Sell,139,3500.93,2021-10-09 01:30:00,486629.26999999996,489704.1400000001
Buy,139,3502.96,2021-10-09 01:45:00,486911.44,2792.70000000007
Sell,139,3493.15,2021-10-09 02:00:00,485547.85000000003,488340.5500000001
Buy,139,3498.98,2021-10-09 02:15:00,486358.22000000003,1982.3300000000745
Sell,139,3490.28,2021-10-09 02:30:00,485148.92000000004,487131.2500000001
Buy,139,3490.28,2021-10-09 02:30:00,485148.92000000004,1982.3300000000745
Sell,139,3475.4,2021-10-09 02:45:00,483080.60000000003,485062.9300000001
Buy,139,3475.4,2021-10-09 02:45:00,483080.60000000003,1982.3300000000745
Sell,139,3454.08,2021-10-09 03:00:00,480117.12,482099.45000000007
Buy,139,3454.08,2021-10-09 03:00:00,480117.12,1982.3300000000745
Sell,139,3462.01,2021-10-09 03:15:00,481219.39,483201.7200000001
Buy,139,3465.97,2021-10-09 04:30:00,481769.82999999996,1431.8900000001304
Sell,139,3454.92,2021-10-09 04:45:00,480233.88,481665.77000000014
Buy,139,3448.5,2021-10-09 05:00:00,479341.5,2324.270000000135
Sell,139,3433.27,2021-10-09 05:15:00,477224.52999999997,479548.8000000001
Buy,138,3453.4,2021-10-09 06:00:00,476569.2,2979.600000000093
Sell,138,3443.05,2021-10-09 06:15:00,475140.9,478120.5000000001
Buy,138,3443.05,2021-10-09 06:15:00,475140.9,2979.600000000093
Sell,138,3429.35,2021-10-09 06:30:00,473250.3,476229.9000000001
Buy,138,3429.35,2021-10-09 06:30:00,473250.3,2979.600000000093
Sell,138,3421.48,2021-10-09 06:45:00,472164.24,475143.8400000001
Buy,138,3423.49,2021-10-09 07:15:00,472441.62,2702.2200000000885
Sell,138,3418.21,2021-10-09 07:30:00,471712.98,474415.20000000007
Buy,138,3418.21,2021-10-09 07:30:00,471712.98,2702.2200000000885
Sell,138,3405.59,2021-10-09 07:45:00,469971.42000000004,472673.64000000013
Buy,138,3405.59,2021-10-09 07:45:00,469971.42000000004,2702.2200000000885
Sell,138,3389.69,2021-10-09 08:00:00,467777.22000000003,470479.4400000001
Buy,138,3406.42,2021-10-09 08:15:00,470085.96,393.4800000000978
Sell,138,3376.12,2021-10-09 08:30:00,465904.56,466298.0400000001
Buy,138,3376.12,2021-10-09 08:30:00,465904.56,393.4800000000978
Sell,138,3376.81,2021-10-09 08:45:00,465999.77999999997,466393.26000000007
Buy,137,3400.44,2021-10-09 09:30:00,465860.28,532.9800000000396
Sell,137,3401.96,2021-10-09 09:45:00,466068.52,466601.50000000006
Buy,137,3401.11,2021-10-09 10:00:00,465952.07,649.4300000000512
Sell,137,3391.22,2021-10-09 10:15:00,464597.13999999996,465246.57
Buy,136,3419.54,2021-10-09 10:30:00,465057.44,189.13000000000466
Sell,136,3406.06,2021-10-09 10:45:00,463224.16,463413.29
Buy,136,3406.06,2021-10-09 10:45:00,463224.16,189.13000000000466
Sell,136,3392.72,2021-10-09 11:00:00,461409.92,461599.05
Buy,136,3392.72,2021-10-09 11:00:00,461409.92,189.13000000000466
Sell,136,3387.32,2021-10-09 11:15:00,460675.52,460864.65
Buy,136,3387.32,2021-10-09 11:15:00,460675.52,189.13000000000466
Sell,136,3386.15,2021-10-09 11:30:00,460516.4,460705.53
Buy,135,3404.12,2021-10-09 11:45:00,459556.2,1149.3300000000163
Sell,135,3398.36,2021-10-09 12:00:00,458778.60000000003,459927.93000000005
Buy,135,3398.36,2021-10-09 12:00:00,458778.60000000003,1149.3300000000163
Sell,135,3383.27,2021-10-09 12:15:00,456741.45,457890.78
Buy,134,3394.54,2021-10-09 12:30:00,454868.36,3022.420000000042
Sell,134,3375.0,2021-10-09 12:45:00,452250.0,455272.42000000004
Buy,134,3375.0,2021-10-09 12:45:00,452250.0,3022.420000000042
Sell,134,3362.27,2021-10-09 13:00:00,450544.18,453566.60000000003
Buy,134,3362.27,2021-10-09 13:00:00,450544.18,3022.420000000042
Sell,134,3356.33,2021-10-09 13:15:00,449748.22,452770.64
Buy,134,3356.33,2021-10-09 13:15:00,449748.22,3022.420000000042
Sell,134,3328.69,2021-10-09 13:30:00,446044.46,449066.88000000006
Buy,134,3328.69,2021-10-09 13:30:00,446044.46,3022.420000000042
Sell,134,3327.28,2021-10-09 13:45:00,445855.52,448877.94000000006
Buy,134,3327.28,2021-10-09 13:45:00,445855.52,3022.420000000042
Sell,134,3304.58,2021-10-09 14:00:00,442813.72,445836.14
Buy,134,3304.58,2021-10-09 14:00:00,442813.72,3022.420000000042
Sell,134,3266.01,2021-10-09 14:15:00,437645.34,440667.76000000007
Buy,134,3266.01,2021-10-09 14:15:00,437645.34,3022.420000000042
Sell,134,3229.59,2021-10-09 14:30:00,432765.06,435787.48000000004
Buy,133,3257.0,2021-10-09 14:45:00,433181.0,2606.4800000000396
Sell,133,3242.79,2021-10-09 15:00:00,431291.07,433897.55000000005
Buy,131,3299.28,2021-10-09 15:45:00,432205.68000000005,1691.8699999999953
Sell,131,3285.0,2021-10-09 16:00:00,430335.0,432026.87
Buy,130,3300.67,2021-10-09 16:15:00,429087.10000000003,2939.7699999999604
Sell,130,3294.49,2021-10-09 16:30:00,428283.69999999995,431223.4699999999
Buy,130,3294.49,2021-10-09 16:30:00,428283.69999999995,2939.7699999999604
Sell,130,3297.04,2021-10-09 16:45:00,428615.2,431554.97
Buy,129,3333.77,2021-10-09 18:00:00,430056.33,1498.6399999999558
Sell,129,3342.34,2021-10-09 18:15:00,431161.86000000004,432660.5
Buy,129,3342.34,2021-10-09 18:15:00,431161.86000000004,1498.6399999999558
Sell,129,3336.11,2021-10-09 18:30:00,430358.19,431856.82999999996
Buy,129,3336.11,2021-10-09 18:30:00,430358.19,1498.6399999999558
Sell,129,3329.83,2021-10-09 18:45:00,429548.07,431046.70999999996
Buy,129,3329.83,2021-10-09 18:45:00,429548.07,1498.6399999999558
Sell,129,3322.4,2021-10-09 19:00:00,428589.60000000003,430088.24
Buy,129,3322.4,2021-10-09 19:00:00,428589.60000000003,1498.6399999999558
Sell,129,3315.92,2021-10-09 19:15:00,427753.68,429252.31999999995
Buy,129,3315.92,2021-10-09 19:15:00,427753.68,1498.6399999999558
Sell,129,3313.94,2021-10-09 19:30:00,427498.26,428996.89999999997
Buy,129,3313.94,2021-10-09 19:30:00,427498.26,1498.6399999999558
Sell,129,3312.62,2021-10-09 19:45:00,427327.98,428826.61999999994
Buy,128,3325.67,2021-10-09 20:00:00,425685.76,3140.859999999928
Sell,128,3316.96,2021-10-09 20:15:00,424570.88,427711.73999999993
Buy,128,3316.96,2021-10-09 20:15:00,424570.88,3140.859999999928
Sell,128,3279.46,2021-10-09 20:30:00,419770.88,422911.73999999993
Buy,128,3279.46,2021-10-09 20:30:00,419770.88,3140.859999999928
Sell,128,3250.11,2021-10-09 20:45:00,416014.08,419154.93999999994
Buy,128,3261.22,2021-10-09 21:15:00,417436.16,1718.7799999999697
Sell,128,3183.12,2021-10-09 21:30:00,407439.36,409158.13999999996
Buy,128,3183.12,2021-10-09 21:30:00,407439.36,1718.7799999999697
Sell,128,3183.74,2021-10-09 21:45:00,407518.72,409237.49999999994
Buy,127,3205.02,2021-10-09 22:30:00,407037.54,2199.9599999999627
Sell,127,3174.81,2021-10-09 22:45:00,403200.87,405400.82999999996
Buy,126,3199.25,2021-10-09 23:15:00,403105.5,2295.329999999958
Sell,126,3202.5,2021-10-09 23:30:00,403515.0,405810.32999999996
Buy,113,3570.0,2021-10-10 00:00:00,403410.0,2400.329999999958
Sell,113,3584.18,2021-10-10 00:15:00,405012.33999999997,407412.6699999999
Buy,113,3584.18,2021-10-10 00:15:00,405012.33999999997,2400.329999999958
Sell,113,3577.89,2021-10-10 00:30:00,404301.57,406701.89999999997
Buy,113,3577.89,2021-10-10 00:30:00,404301.57,2400.329999999958
Sell,113,3569.1,2021-10-10 00:45:00,403308.3,405708.62999999995
Buy,113,3569.1,2021-10-10 00:45:00,403308.3,2400.329999999958
Sell,113,3549.66,2021-10-10 01:00:00,401111.57999999996,403511.9099999999
Buy,113,3549.66,2021-10-10 01:00:00,401111.57999999996,2400.329999999958
Sell,113,3514.87,2021-10-10 01:15:00,397180.31,399580.63999999996
Buy,113,3514.87,2021-10-10 01:15:00,397180.31,2400.329999999958
Sell,113,3503.52,2021-10-10 01:30:00,395897.76,398298.08999999997
Buy,112,3535.22,2021-10-10 03:15:00,395944.63999999996,2353.4500000000116
Sell,112,3535.14,2021-10-10 03:30:00,395935.68,398289.13
Buy,112,3535.14,2021-10-10 03:30:00,395935.68,2353.4500000000116
Sell,112,3532.41,2021-10-10 03:45:00,395629.92,397983.37
Buy,112,3537.9,2021-10-10 04:15:00,396244.8,1738.570000000007
Sell,112,3527.88,2021-10-10 04:30:00,395122.56,396861.13
Buy,104,3805.72,2021-10-10 05:15:00,395794.88,1066.25
Sell,104,3564.06,2021-10-10 05:30:00,370662.24,371728.49
Buy,104,3564.06,2021-10-10 05:30:00,370662.24,1066.25
Sell,104,3567.34,2021-10-10 05:45:00,371003.36,372069.61
Buy,103,3593.97,2021-10-10 07:00:00,370178.91,1890.7000000000116
Sell,103,3587.91,2021-10-10 07:15:00,369554.73,371445.43
Buy,103,3587.91,2021-10-10 07:15:00,369554.73,1890.7000000000116
Sell,103,3585.99,2021-10-10 07:30:00,369356.97,371247.67
Buy,103,3585.99,2021-10-10 07:30:00,369356.97,1890.7000000000116
Sell,103,3585.49,2021-10-10 07:45:00,369305.47,371196.17
Buy,103,3587.4,2021-10-10 08:00:00,369502.2,1693.969999999972
Sell,103,3595.19,2021-10-10 08:15:00,370304.57,371998.54
Buy,103,3595.73,2021-10-10 08:30:00,370360.19,1638.3499999999767
Sell,103,3592.34,2021-10-10 08:45:00,370011.02,371649.37
Buy,103,3592.34,2021-10-10 08:45:00,370011.02,1638.3499999999767
Sell,103,3576.06,2021-10-10 09:00:00,368334.18,369972.52999999997
Buy,103,3583.99,2021-10-10 09:15:00,369150.97,821.5599999999977
Sell,103,3568.28,2021-10-10 09:30:00,367532.84,368354.4
Buy,103,3568.28,2021-10-10 09:30:00,367532.84,821.5599999999977
Sell,103,3574.52,2021-10-10 09:45:00,368175.56,368997.12
Buy,103,3581.5,2021-10-10 10:00:00,368894.5,102.61999999999534
Sell,103,3581.51,2021-10-10 10:15:00,368895.53,368998.15
Buy,103,3581.51,2021-10-10 10:15:00,368895.53,102.61999999999534
Sell,103,3575.16,2021-10-10 10:30:00,368241.48,368344.1
Buy,103,3575.16,2021-10-10 10:30:00,368241.48,102.61999999999534
Sell,103,3568.91,2021-10-10 10:45:00,367597.73,367700.35
Buy,103,3568.91,2021-10-10 10:45:00,367597.73,102.61999999999534
Sell,103,3557.22,2021-10-10 11:00:00,366393.66,366496.27999999997
Buy,96,3805.72,2021-10-10 11:30:00,365349.12,1147.1599999999744
Sell,96,3565.69,2021-10-10 11:45:00,342306.24,343453.39999999997
Buy,96,3565.69,2021-10-10 11:45:00,342306.24,1147.1599999999744
Sell,96,3551.73,2021-10-10 12:00:00,340966.08,342113.24
Buy,96,3551.73,2021-10-10 12:00:00,340966.08,1147.1599999999744
Sell,96,3534.81,2021-10-10 12:15:00,339341.76,340488.92
Buy,95,3554.61,2021-10-10 13:15:00,337687.95,2800.969999999972
Sell,95,3550.41,2021-10-10 13:30:00,337288.95,340089.92
Buy,95,3566.32,2021-10-10 14:15:00,338800.4,1289.5199999999604
Sell,95,3553.34,2021-10-10 14:30:00,337567.3,338856.81999999995
Buy,95,3553.34,2021-10-10 14:30:00,337567.3,1289.5199999999604
Sell,95,3552.01,2021-10-10 14:45:00,337440.95,338730.47
Buy,95,3559.18,2021-10-10 15:45:00,338122.1,608.3699999999953
Sell,95,3556.67,2021-10-10 16:00:00,337883.65,338492.02
Buy,95,3556.67,2021-10-10 16:00:00,337883.65,608.3699999999953
Sell,95,3537.3,2021-10-10 16:15:00,336043.5,336651.87
Buy,94,3548.12,2021-10-10 16:45:00,333523.27999999997,3128.5900000000256
Sell,94,3516.52,2021-10-10 17:00:00,330552.88,333681.47000000003
Buy,94,3516.52,2021-10-10 17:00:00,330552.88,3128.5900000000256
Sell,94,3517.01,2021-10-10 17:15:00,330598.94,333727.53
Buy,94,3524.34,2021-10-10 17:45:00,331287.96,2439.570000000007
Sell,94,3512.04,2021-10-10 18:00:00,330131.76,332571.33
Buy,94,3512.04,2021-10-10 18:00:00,330131.76,2439.570000000007
Sell,94,3516.5,2021-10-10 18:15:00,330551.0,332990.57
Buy,94,3528.23,2021-10-10 19:00:00,331653.62,1336.9500000000116
Sell,94,3533.31,2021-10-10 19:15:00,332131.14,333468.09
Buy,94,3530.5,2021-10-10 19:30:00,331867.0,1601.0900000000256
Sell,94,3530.0,2021-10-10 19:45:00,331820.0,333421.09
Buy,93,3553.55,2021-10-10 20:15:00,330480.15,2940.9400000000023
Sell,93,3524.91,2021-10-10 20:30:00,327816.63,330757.57
Buy,93,3524.91,2021-10-10 20:30:00,327816.63,2940.9400000000023
Sell,93,3514.32,2021-10-10 20:45:00,326831.76,329772.7
Buy,93,3514.32,2021-10-10 20:45:00,326831.76,2940.9400000000023
Sell,93,3469.05,2021-10-10 21:00:00,322621.65,325562.59
Buy,93,3469.05,2021-10-10 21:00:00,322621.65,2940.9400000000023
Sell,93,3452.0,2021-10-10 21:15:00,321036.0,323976.94
Buy,93,3474.31,2021-10-10 21:30:00,323110.83,866.109999999986
Sell,93,3457.66,2021-10-10 21:45:00,321562.38,322428.49
Buy,93,3457.66,2021-10-10 21:45:00,321562.38,866.109999999986
Sell,93,3452.25,2021-10-10 22:00:00,321059.25,321925.36
Buy,93,3449.47,2021-10-10 22:15:00,320800.70999999996,1124.6500000000233
Sell,93,3447.82,2021-10-10 22:30:00,320647.26,321771.91000000003
Buy,92,3467.61,2021-10-10 22:45:00,319020.12,2751.7900000000373
Sell,92,3455.77,2021-10-10 23:00:00,317930.84,320682.63000000006
Buy,92,3455.77,2021-10-10 23:00:00,317930.84,2751.7900000000373
Sell,92,3448.2,2021-10-10 23:15:00,317234.39999999997,319986.19
Buy,92,3448.2,2021-10-10 23:15:00,317234.39999999997,2751.7900000000373
Sell,92,3423.85,2021-10-10 23:30:00,314994.2,317745.99000000005
Buy,66,4750.45,2021-10-11 00:00:00,313529.7,4216.290000000037
Sell,66,4754.49,2021-10-11 00:15:00,313796.33999999997,318012.63
Buy,66,4754.49,2021-10-11 00:15:00,313796.33999999997,4216.290000000037
Sell,66,4722.65,2021-10-11 00:30:00,311694.89999999997,315911.19
Buy,66,4722.65,2021-10-11 00:30:00,311694.89999999997,4216.290000000037
Sell,66,4724.01,2021-10-11 00:45:00,311784.66000000003,316000.95000000007
Buy,66,4724.01,2021-10-11 00:45:00,311784.66000000003,4216.290000000037
Sell,66,4738.12,2021-10-11 01:00:00,312715.92,316932.21
Buy,66,4738.12,2021-10-11 01:00:00,312715.92,4216.290000000037
Sell,66,4744.99,2021-10-11 01:15:00,313169.33999999997,317385.63
Buy,66,4744.99,2021-10-11 01:15:00,313169.33999999997,4216.290000000037
Sell,66,4744.15,2021-10-11 01:30:00,313113.89999999997,317330.19
Buy,66,4744.15,2021-10-11 01:30:00,313113.89999999997,4216.290000000037
Sell,66,4733.59,2021-10-11 01:45:00,312416.94,316633.23000000004
Buy,66,4733.59,2021-10-11 01:45:00,312416.94,4216.290000000037
Sell,66,4746.99,2021-10-11 02:00:00,313301.33999999997,317517.63
Buy,66,4746.99,2021-10-11 02:00:00,313301.33999999997,4216.290000000037
Sell,66,4750.79,2021-10-11 02:15:00,313552.14,317768.43000000005
Buy,66,4750.79,2021-10-11 02:15:00,313552.14,4216.290000000037
Sell,66,4733.94,2021-10-11 02:30:00,312440.04,316656.33
Buy,66,4733.94,2021-10-11 02:30:00,312440.04,4216.290000000037
Sell,66,4740.82,2021-10-11 02:45:00,312894.12,317110.41000000003
Buy,66,4740.82,2021-10-11 02:45:00,312894.12,4216.290000000037
Sell,66,4722.29,2021-10-11 03:00:00,311671.14,315887.43000000005
Buy,66,4722.29,2021-10-11 03:00:00,311671.14,4216.290000000037
Sell,66,4695.63,2021-10-11 03:15:00,309911.58,314127.87000000005
Buy,66,4695.63,2021-10-11 03:15:00,309911.58,4216.290000000037
Sell,66,4684.89,2021-10-11 03:30:00,309202.74000000005,313419.0300000001
Buy,66,4684.89,2021-10-11 03:30:00,309202.74000000005,4216.290000000037
Sell,66,4695.28,2021-10-11 03:45:00,309888.48,314104.77
Buy,66,4713.35,2021-10-11 04:30:00,311081.10000000003,3023.6699999999837
Sell,66,4716.31,2021-10-11 04:45:00,311276.46,314300.13
Buy,66,4716.31,2021-10-11 04:45:00,311276.46,3023.6699999999837
Sell,66,4701.55,2021-10-11 05:00:00,310302.3,313325.97
Buy,66,4706.72,2021-10-11 05:30:00,310643.52,2682.4499999999534
Sell,66,4703.17,2021-10-11 05:45:00,310409.22000000003,313091.67
Buy,66,4742.92,2021-10-11 06:45:00,313032.72000000003,58.949999999953434
Sell,66,4731.09,2021-10-11 07:00:00,312251.94,312310.88999999996
Buy,65,4741.95,2021-10-11 07:15:00,308226.75,4084.1399999999558
Sell,65,4720.9,2021-10-11 07:30:00,306858.5,310942.63999999996
Buy,65,4720.9,2021-10-11 07:30:00,306858.5,4084.1399999999558
Sell,65,4718.79,2021-10-11 07:45:00,306721.35,310805.48999999993
Buy,65,4723.42,2021-10-11 08:00:00,307022.3,3783.189999999944
Sell,65,4730.12,2021-10-11 08:15:00,307457.8,311240.98999999993
Buy,65,4719.07,2021-10-11 08:30:00,306739.55,4501.439999999944
Sell,65,4713.39,2021-10-11 08:45:00,306370.35000000003,310871.79
Buy,65,4713.39,2021-10-11 08:45:00,306370.35000000003,4501.439999999944
Sell,65,4711.04,2021-10-11 09:00:00,306217.6,310719.0399999999
Buy,65,4716.17,2021-10-11 09:15:00,306551.05,4167.9899999999325
Sell,65,4715.48,2021-10-11 09:30:00,306506.19999999995,310674.1899999999
Buy,65,4715.48,2021-10-11 09:30:00,306506.19999999995,4167.9899999999325
Sell,65,4711.84,2021-10-11 09:45:00,306269.60000000003,310437.58999999997
Buy,65,4751.46,2021-10-11 10:30:00,308844.9,1592.6899999999441
Sell,65,4743.33,2021-10-11 10:45:00,308316.45,309909.13999999996
Buy,65,4757.21,2021-10-11 11:00:00,309218.65,690.4899999999325
Sell,65,4738.51,2021-10-11 11:15:00,308003.15,308693.63999999996
Buy,65,4738.51,2021-10-11 11:15:00,308003.15,690.4899999999325
Sell,65,4742.05,2021-10-11 11:30:00,308233.25,308923.73999999993
Buy,64,4753.01,2021-10-11 12:00:00,304192.64,4731.0999999999185
Sell,64,4729.66,2021-10-11 12:15:00,302698.24,307429.3399999999
Buy,65,4729.66,2021-10-11 12:15:00,307427.89999999997,1.4399999999441206
Sell,65,4737.09,2021-10-11 12:30:00,307910.85000000003,307912.29
Buy,65,4737.09,2021-10-11 12:30:00,307910.85000000003,1.4399999999441206
Sell,65,4712.76,2021-10-11 12:45:00,306329.4,306330.83999999997
Buy,65,4712.76,2021-10-11 12:45:00,306329.4,1.4399999999441206
Sell,65,4724.75,2021-10-11 13:00:00,307108.75,307110.18999999994
Buy,65,4724.75,2021-10-11 13:00:00,307108.75,1.4399999999441206
Sell,65,4714.25,2021-10-11 13:15:00,306426.25,306427.68999999994
Buy,65,4714.25,2021-10-11 13:15:00,306426.25,1.4399999999441206
Sell,65,4788.68,2021-10-11 13:30:00,311264.2,311265.63999999996
Buy,65,4788.68,2021-10-11 13:30:00,311264.2,1.4399999999441206
Sell,65,4796.16,2021-10-11 13:45:00,311750.39999999997,311751.8399999999
Buy,65,4796.16,2021-10-11 13:45:00,311750.39999999997,1.4399999999441206
Sell,65,4851.16,2021-10-11 14:00:00,315325.39999999997,315326.8399999999
Buy,65,4851.16,2021-10-11 14:00:00,315325.39999999997,1.4399999999441206
Sell,65,4833.95,2021-10-11 14:15:00,314206.75,314208.18999999994
Buy,65,4833.95,2021-10-11 14:15:00,314206.75,1.4399999999441206
Sell,65,4841.99,2021-10-11 14:30:00,314729.35,314730.7899999999
Buy,65,4841.99,2021-10-11 14:30:00,314729.35,1.4399999999441206
Sell,65,4849.75,2021-10-11 14:45:00,315233.75,315235.18999999994
Buy,65,4849.75,2021-10-11 14:45:00,315233.75,1.4399999999441206
Sell,65,4848.97,2021-10-11 15:00:00,315183.05,315184.48999999993
Buy,65,4848.97,2021-10-11 15:00:00,315183.05,1.4399999999441206
Sell,65,4841.08,2021-10-11 15:15:00,314670.2,314671.63999999996
Buy,65,4841.08,2021-10-11 15:15:00,314670.2,1.4399999999441206
Sell,65,4852.33,2021-10-11 15:30:00,315401.45,315402.88999999996
Buy,65,4852.33,2021-10-11 15:30:00,315401.45,1.4399999999441206
Sell,65,4850.95,2021-10-11 15:45:00,315311.75,315313.18999999994
Buy,65,4850.95,2021-10-11 15:45:00,315311.75,1.4399999999441206
Sell,65,4846.97,2021-10-11 16:00:00,315053.05,315054.48999999993
Buy,65,4846.97,2021-10-11 16:00:00,315053.05,1.4399999999441206
Sell,65,4850.66,2021-10-11 16:15:00,315292.89999999997,315294.3399999999
Buy,65,4850.66,2021-10-11 16:15:00,315292.89999999997,1.4399999999441206
Sell,65,4840.54,2021-10-11 16:30:00,314635.1,314636.5399999999
Buy,65,4840.54,2021-10-11 16:30:00,314635.1,1.4399999999441206
Sell,65,4852.08,2021-10-11 16:45:00,315385.2,315386.63999999996
Buy,65,4852.08,2021-10-11 16:45:00,315385.2,1.4399999999441206
Sell,65,4844.44,2021-10-11 17:00:00,314888.6,314890.0399999999
Buy,65,4844.44,2021-10-11 17:00:00,314888.6,1.4399999999441206
Sell,65,4849.56,2021-10-11 17:15:00,315221.4,315222.83999999997
Buy,65,4849.56,2021-10-11 17:15:00,315221.4,1.4399999999441206
Sell,65,4840.75,2021-10-11 17:30:00,314648.75,314650.18999999994
Buy,65,4840.75,2021-10-11 17:30:00,314648.75,1.4399999999441206
Sell,65,4844.63,2021-10-11 17:45:00,314900.95,314902.38999999996
Buy,65,4844.63,2021-10-11 17:45:00,314900.95,1.4399999999441206
Sell,65,4823.39,2021-10-11 18:00:00,313520.35000000003,313521.79
Buy,65,4823.39,2021-10-11 18:00:00,313520.35000000003,1.4399999999441206
Sell,65,4817.4,2021-10-11 18:15:00,313131.0,313132.43999999994
Buy,65,4817.4,2021-10-11 18:15:00,313131.0,1.4399999999441206
Sell,65,4800.51,2021-10-11 18:30:00,312033.15,312034.58999999997
Buy,65,4800.51,2021-10-11 18:30:00,312033.15,1.4399999999441206
Sell,65,4786.98,2021-10-11 18:45:00,311153.69999999995,311155.1399999999
Buy,64,4808.07,2021-10-11 19:00:00,307716.48,3438.659999999916
Sell,64,4786.5,2021-10-11 19:15:00,306336.0,309774.6599999999
Buy,64,4786.5,2021-10-11 19:15:00,306336.0,3438.659999999916
Sell,64,4739.73,2021-10-11 19:30:00,303342.72,306781.3799999999
Buy,64,4739.73,2021-10-11 19:30:00,303342.72,3438.659999999916
Sell,64,4706.16,2021-10-11 19:45:00,301194.24,304632.8999999999
Buy,64,4706.16,2021-10-11 19:45:00,301194.24,3438.659999999916
Sell,64,4696.0,2021-10-11 20:00:00,300544.0,303982.6599999999
Buy,64,4702.57,2021-10-11 20:15:00,300964.48,3018.179999999935
Sell,64,4675.02,2021-10-11 20:30:00,299201.28,302219.45999999996
Buy,64,4675.02,2021-10-11 20:30:00,299201.28,3018.179999999935
Sell,64,4641.27,2021-10-11 20:45:00,297041.28,300059.45999999996
Buy,64,4641.27,2021-10-11 20:45:00,297041.28,3018.179999999935
Sell,64,4624.26,2021-10-11 21:00:00,295952.64,298970.81999999995
Buy,64,4624.26,2021-10-11 21:00:00,295952.64,3018.179999999935
Sell,64,4581.28,2021-10-11 21:15:00,293201.92,296220.0999999999
Buy,64,4623.42,2021-10-11 21:30:00,295898.88,321.21999999991385
Sell,64,4557.42,2021-10-11 21:45:00,291674.88,291996.0999999999
Buy,64,4557.42,2021-10-11 21:45:00,291674.88,321.21999999991385
Sell,64,4606.33,2021-10-11 22:00:00,294805.12,295126.3399999999
Buy,64,4606.33,2021-10-11 22:00:00,294805.12,321.21999999991385
Sell,64,4592.51,2021-10-11 22:15:00,293920.64,294241.8599999999
Buy,64,4592.51,2021-10-11 22:15:00,293920.64,321.21999999991385
Sell,64,4613.13,2021-10-11 22:30:00,295240.32,295561.5399999999
Buy,64,4613.13,2021-10-11 22:30:00,295240.32,321.21999999991385
Sell,64,4644.64,2021-10-11 22:45:00,297256.96,297578.17999999993
Buy,64,4644.64,2021-10-11 22:45:00,297256.96,321.21999999991385
Sell,64,4632.0,2021-10-11 23:00:00,296448.0,296769.2199999999
Buy,64,4632.0,2021-10-11 23:00:00,296448.0,321.21999999991385
Sell,64,4604.42,2021-10-11 23:15:00,294682.88,295004.0999999999
Buy,64,4604.42,2021-10-11 23:15:00,294682.88,321.21999999991385
Sell,64,4615.97,2021-10-11 23:30:00,295422.08,295743.29999999993
Buy,64,4615.97,2021-10-11 23:30:00,295422.08,321.21999999991385
Sell,64,4632.21,2021-10-11 23:45:00,296461.44,296782.6599999999
Buy,64,4632.21,2021-10-11 23:45:00,296461.44,321.21999999991385
Sell,64,4136.88,2021-10-12 00:00:00,264760.32,265081.5399999999
Buy,63,4146.47,2021-10-12 00:30:00,261227.61000000002,3853.9299999999057
Sell,63,4118.56,2021-10-12 00:45:00,259469.28000000003,263323.20999999996
Buy,63,4144.7,2021-10-12 01:00:00,261116.09999999998,2207.109999999986
Sell,63,4165.59,2021-10-12 01:15:00,262432.17,264639.27999999997
Buy,63,4180.6,2021-10-12 02:30:00,263377.80000000005,1261.4799999999232
Sell,63,4164.81,2021-10-12 02:45:00,262383.03,263644.50999999995
Buy,63,4164.81,2021-10-12 02:45:00,262383.03,1261.4799999999232
Sell,63,4151.59,2021-10-12 03:00:00,261550.17,262811.6499999999
Buy,63,4146.21,2021-10-12 03:15:00,261211.23,1600.4199999998964
Sell,63,4130.17,2021-10-12 03:30:00,260200.71,261801.1299999999
Buy,63,4146.07,2021-10-12 04:00:00,261202.40999999997,598.7199999999139
Sell,63,4155.0,2021-10-12 04:15:00,261765.0,262363.7199999999
Buy,63,4155.0,2021-10-12 04:15:00,261765.0,598.7199999999139
Sell,63,4132.57,2021-10-12 04:30:00,260351.90999999997,260950.6299999999
Buy,63,4132.57,2021-10-12 04:30:00,260351.90999999997,598.7199999999139
Sell,63,4125.06,2021-10-12 04:45:00,259878.78000000003,260477.49999999994
Buy,63,4127.37,2021-10-12 05:00:00,260024.31,453.1899999999441
Sell,63,4121.17,2021-10-12 05:15:00,259633.71,260086.89999999994
Buy,63,4121.17,2021-10-12 05:15:00,259633.71,453.1899999999441
Sell,63,4112.08,2021-10-12 05:30:00,259061.04,259514.22999999995
Buy,62,4130.16,2021-10-12 06:00:00,256069.91999999998,3444.3099999999686
Sell,62,4113.47,2021-10-12 06:15:00,255035.14,258479.44999999998
Buy,62,4113.47,2021-10-12 06:15:00,255035.14,3444.3099999999686
Sell,62,4121.33,2021-10-12 06:30:00,255522.46,258966.76999999996
Buy,62,4121.33,2021-10-12 06:30:00,255522.46,3444.3099999999686
Sell,62,4065.54,2021-10-12 06:45:00,252063.48,255507.78999999998
Buy,62,4065.54,2021-10-12 06:45:00,252063.48,3444.3099999999686
Sell,62,4063.09,2021-10-12 07:00:00,251911.58000000002,255355.88999999998
Buy,62,4068.36,2021-10-12 07:15:00,252238.32,3117.569999999978
Sell,62,4068.35,2021-10-12 07:30:00,252237.69999999998,255355.26999999996
Buy,62,4068.35,2021-10-12 07:30:00,252237.69999999998,3117.569999999978
Sell,62,4029.38,2021-10-12 07:45:00,249821.56,252939.12999999998
Buy,62,4029.38,2021-10-12 07:45:00,249821.56,3117.569999999978
Sell,62,4031.39,2021-10-12 08:00:00,249946.18,253063.74999999997
Buy,62,4073.71,2021-10-12 09:00:00,252570.02,493.7299999999814
Sell,62,4058.09,2021-10-12 09:15:00,251601.58000000002,252095.31
Buy,61,4099.56,2021-10-12 09:45:00,250073.16000000003,2022.149999999965
Sell,61,4105.85,2021-10-12 10:00:00,250456.85000000003,252479.0
Buy,61,4094.79,2021-10-12 10:15:00,249782.19,2696.8099999999977
Sell,61,4098.33,2021-10-12 10:30:00,249998.13,252694.94
Buy,61,4098.33,2021-10-12 10:30:00,249998.13,2696.8099999999977
Sell,61,4088.78,2021-10-12 10:45:00,249415.58000000002,252112.39
Buy,60,4182.87,2021-10-12 12:00:00,250972.19999999998,1140.1900000000314
Sell,60,4156.62,2021-10-12 12:15:00,249397.19999999998,250537.39
Buy,60,4156.62,2021-10-12 12:15:00,249397.19999999998,1140.1900000000314
Sell,60,4156.16,2021-10-12 12:30:00,249369.59999999998,250509.79
Buy,60,4167.85,2021-10-12 12:45:00,250071.00000000003,438.78999999997905
Sell,60,4162.95,2021-10-12 13:00:00,249777.0,250215.78999999998
Buy,60,4162.95,2021-10-12 13:00:00,249777.0,438.78999999997905
Sell,60,4140.47,2021-10-12 13:15:00,248428.2,248866.99
Buy,59,4200.96,2021-10-12 13:45:00,247856.64,1010.3499999999767
Sell,59,4198.13,2021-10-12 14:00:00,247689.67,248700.02
Buy,59,4198.13,2021-10-12 14:00:00,247689.67,1010.3499999999767
Sell,59,4175.47,2021-10-12 14:15:00,246352.73,247363.08
Buy,59,4170.92,2021-10-12 14:30:00,246084.28,1278.7999999999884
Sell,59,4028.9,2021-10-12 14:45:00,237705.1,238983.9
Buy,59,4028.9,2021-10-12 14:45:00,237705.1,1278.7999999999884
Sell,59,4041.11,2021-10-12 15:00:00,238425.49000000002,239704.29
Buy,59,4041.11,2021-10-12 15:00:00,238425.49000000002,1278.7999999999884
Sell,59,3805.72,2021-10-12 15:15:00,224537.47999999998,225816.27999999997
Buy,55,4052.55,2021-10-12 15:30:00,222890.25,2926.0299999999697
Sell,55,4020.1,2021-10-12 15:45:00,221105.5,224031.52999999997
Buy,55,4020.1,2021-10-12 15:45:00,221105.5,2926.0299999999697
Sell,55,3987.73,2021-10-12 16:00:00,219325.15,222251.17999999996
Buy,55,3985.76,2021-10-12 16:30:00,219216.80000000002,3034.3799999999464
Sell,55,3975.18,2021-10-12 16:45:00,218634.9,221669.27999999994
Buy,55,3975.18,2021-10-12 16:45:00,218634.9,3034.3799999999464
Sell,55,3978.23,2021-10-12 17:00:00,218802.65,221837.02999999994
Buy,55,3978.23,2021-10-12 17:00:00,218802.65,3034.3799999999464
Sell,55,3939.17,2021-10-12 17:15:00,216654.35,219688.72999999995
Buy,55,3992.59,2021-10-12 18:30:00,219592.45,96.27999999994063
Sell,55,3981.16,2021-10-12 18:45:00,218963.8,219060.07999999993
Buy,55,3981.16,2021-10-12 18:45:00,218963.8,96.27999999994063
Sell,55,3976.06,2021-10-12 19:00:00,218683.3,218779.57999999993
Buy,54,4022.02,2021-10-12 20:00:00,217189.08,1590.4999999999418
Sell,54,4021.38,2021-10-12 20:15:00,217154.52000000002,218745.01999999996
Buy,54,4021.38,2021-10-12 20:15:00,217154.52000000002,1590.4999999999418
Sell,54,4015.88,2021-10-12 20:30:00,216857.52000000002,218448.01999999996
Buy,53,4049.71,2021-10-12 20:45:00,214634.63,3813.3899999999558
Sell,53,4037.5,2021-10-12 21:00:00,213987.5,217800.88999999996
Buy,53,4037.5,2021-10-12 21:00:00,213987.5,3813.3899999999558
Sell,53,4034.74,2021-10-12 21:15:00,213841.22,217654.60999999996
Buy,53,4034.74,2021-10-12 21:15:00,213841.22,3813.3899999999558
Sell,53,3805.72,2021-10-12 21:30:00,201703.16,205516.54999999996
Buy,51,3994.19,2021-10-12 22:00:00,203703.69,1812.859999999957
Sell,51,3982.97,2021-10-12 22:15:00,203131.47,204944.32999999996
Buy,51,3986.08,2021-10-12 22:30:00,203290.08,1654.249999999971
Sell,51,3958.57,2021-10-12 22:45:00,201887.07,203541.31999999998
Buy,51,3958.57,2021-10-12 22:45:00,201887.07,1654.249999999971
Sell,51,3945.89,2021-10-12 23:00:00,201240.38999999998,202894.63999999996
Buy,51,3945.89,2021-10-12 23:00:00,201240.38999999998,1654.249999999971
Sell,51,3805.72,2021-10-12 23:15:00,194091.72,195745.96999999997
Buy,50,3895.95,2021-10-12 23:45:00,194797.5,948.4699999999721
Sell,50,3508.21,2021-10-13 00:00:00,175410.5,176358.96999999997
Buy,50,3503.22,2021-10-13 01:45:00,175161.0,1197.969999999972
Sell,50,3502.97,2021-10-13 02:00:00,175148.5,176346.46999999997
Buy,50,3519.79,2021-10-13 02:45:00,175989.5,356.96999999997206
Sell,50,3510.17,2021-10-13 03:00:00,175508.5,175865.46999999997
Buy,50,3510.17,2021-10-13 03:00:00,175508.5,356.96999999997206
Sell,50,3506.56,2021-10-13 03:15:00,175328.0,175684.96999999997
Buy,50,3506.13,2021-10-13 03:30:00,175306.5,378.46999999997206
Sell,50,3503.62,2021-10-13 03:45:00,175181.0,175559.46999999997
Buy,50,3507.51,2021-10-13 04:15:00,175375.5,183.96999999997206
Sell,50,3508.87,2021-10-13 04:30:00,175443.5,175627.46999999997
Buy,49,3513.69,2021-10-13 05:00:00,172170.81,3456.6599999999744
Sell,49,3511.33,2021-10-13 05:15:00,172055.16999999998,175511.82999999996
Buy,49,3511.33,2021-10-13 05:15:00,172055.16999999998,3456.6599999999744
Sell,49,3456.34,2021-10-13 05:30:00,169360.66,172817.31999999998
Buy,50,3456.34,2021-10-13 05:30:00,172817.0,0.3199999999778811
Sell,50,3453.08,2021-10-13 05:45:00,172654.0,172654.31999999998
Buy,49,3463.5,2021-10-13 06:00:00,169711.5,2942.819999999978
Sell,49,3470.98,2021-10-13 06:15:00,170078.02,173020.83999999997
Buy,49,3470.98,2021-10-13 06:15:00,170078.02,2942.819999999978
Sell,49,3457.01,2021-10-13 06:30:00,169393.49000000002,172336.31
Buy,49,3457.01,2021-10-13 06:30:00,169393.49000000002,2942.819999999978
Sell,49,3463.77,2021-10-13 06:45:00,169724.73,172667.55
Buy,49,3463.77,2021-10-13 06:45:00,169724.73,2942.819999999978
Sell,49,3459.56,2021-10-13 07:00:00,169518.44,172461.25999999998
Buy,49,3459.56,2021-10-13 07:00:00,169518.44,2942.819999999978
Sell,49,3450.9,2021-10-13 07:15:00,169094.1,172036.91999999998
Buy,49,3450.9,2021-10-13 07:15:00,169094.1,2942.819999999978
Sell,49,3437.68,2021-10-13 07:30:00,168446.31999999998,171389.13999999996
Buy,49,3437.68,2021-10-13 07:30:00,168446.31999999998,2942.819999999978
Sell,49,3429.43,2021-10-13 07:45:00,168042.06999999998,170984.88999999996
Buy,49,3452.6,2021-10-13 08:15:00,169177.4,1807.4899999999616
Sell,49,3443.27,2021-10-13 08:30:00,168720.23,170527.71999999997
Buy,49,3443.27,2021-10-13 08:30:00,168720.23,1807.4899999999616
Sell,49,3428.05,2021-10-13 08:45:00,167974.45,169781.93999999997
Buy,49,3428.05,2021-10-13 08:45:00,167974.45,1807.4899999999616
Sell,49,3425.32,2021-10-13 09:00:00,167840.68000000002,169648.16999999998
Buy,49,3444.6,2021-10-13 09:15:00,168785.4,862.7699999999895
Sell,49,3438.23,2021-10-13 09:30:00,168473.27,169336.03999999998
Buy,48,3466.12,2021-10-13 10:15:00,166373.76,2962.2799999999697
Sell,48,3453.12,2021-10-13 10:30:00,165749.76,168712.03999999998
Buy,48,3453.12,2021-10-13 10:30:00,165749.76,2962.2799999999697
Sell,48,3451.49,2021-10-13 10:45:00,165671.52,168633.79999999996
Buy,48,3451.49,2021-10-13 10:45:00,165671.52,2962.2799999999697
Sell,48,3452.79,2021-10-13 11:00:00,165733.91999999998,168696.19999999995
Buy,48,3452.79,2021-10-13 11:00:00,165733.91999999998,2962.2799999999697
Sell,48,3451.0,2021-10-13 11:15:00,165648.0,168610.27999999997
Buy,48,3469.35,2021-10-13 11:45:00,166528.8,2081.4799999999814
Sell,48,3472.15,2021-10-13 12:00:00,166663.2,168744.68
Buy,48,3472.15,2021-10-13 12:00:00,166663.2,2081.4799999999814
Sell,48,3464.17,2021-10-13 12:15:00,166280.16,168361.63999999998
Buy,48,3464.17,2021-10-13 12:15:00,166280.16,2081.4799999999814
Sell,48,3453.62,2021-10-13 12:30:00,165773.76,167855.24
Buy,48,3469.34,2021-10-13 13:00:00,166528.32,1326.9199999999837
Sell,48,3463.04,2021-10-13 13:15:00,166225.91999999998,167552.83999999997
Buy,48,3463.04,2021-10-13 13:15:00,166225.91999999998,1326.9199999999837
Sell,48,3458.6,2021-10-13 13:30:00,166012.8,167339.71999999997
Buy,48,3458.6,2021-10-13 13:30:00,166012.8,1326.9199999999837
Sell,48,3442.65,2021-10-13 13:45:00,165247.2,166574.12
Buy,48,3442.65,2021-10-13 13:45:00,165247.2,1326.9199999999837
Sell,48,3423.0,2021-10-13 14:00:00,164304.0,165630.91999999998
Buy,47,3487.96,2021-10-13 14:45:00,163934.12,1696.7999999999884
Sell,47,3501.58,2021-10-13 15:00:00,164574.26,166271.06
Buy,47,3501.58,2021-10-13 15:00:00,164574.26,1696.7999999999884
Sell,47,3487.67,2021-10-13 15:15:00,163920.49,165617.28999999998
Buy,47,3487.67,2021-10-13 15:15:00,163920.49,1696.7999999999884
Sell,47,3488.69,2021-10-13 15:30:00,163968.43,165665.22999999998
Buy,47,3488.69,2021-10-13 15:30:00,163968.43,1696.7999999999884
Sell,47,3487.12,2021-10-13 15:45:00,163894.63999999998,165591.43999999997
Buy,47,3487.12,2021-10-13 15:45:00,163894.63999999998,1696.7999999999884
Sell,47,3490.04,2021-10-13 16:00:00,164031.88,165728.68
Buy,47,3490.04,2021-10-13 16:00:00,164031.88,1696.7999999999884
Sell,47,3489.79,2021-10-13 16:15:00,164020.13,165716.93
Buy,47,3507.63,2021-10-13 16:30:00,164858.61000000002,858.3199999999779
Sell,47,3494.4,2021-10-13 16:45:00,164236.80000000002,165095.12
Buy,47,3494.4,2021-10-13 16:45:00,164236.80000000002,858.3199999999779
Sell,47,3499.07,2021-10-13 17:00:00,164456.29,165314.61
Buy,47,3516.08,2021-10-13 17:15:00,165255.76,58.84999999997672
Sell,47,3512.45,2021-10-13 17:30:00,165085.15,165143.99999999997
Buy,47,3512.45,2021-10-13 17:30:00,165085.15,58.84999999997672
Sell,47,3512.32,2021-10-13 17:45:00,165079.04,165137.88999999998
Buy,46,3525.57,2021-10-13 18:15:00,162176.22,2961.6699999999837
Sell,46,3524.57,2021-10-13 18:30:00,162130.22,165091.88999999998
Buy,46,3524.57,2021-10-13 18:30:00,162130.22,2961.6699999999837
Sell,46,3513.84,2021-10-13 18:45:00,161636.64,164598.31
Buy,46,3519.99,2021-10-13 19:15:00,161919.53999999998,2678.7700000000186
Sell,46,3519.05,2021-10-13 19:30:00,161876.30000000002,164555.07000000004
Buy,46,3570.84,2021-10-13 20:30:00,164258.64,296.4300000000221
Sell,46,3576.81,2021-10-13 20:45:00,164533.26,164829.69000000003
Buy,45,3585.15,2021-10-13 21:30:00,161331.75,3497.9400000000314
Sell,45,3574.58,2021-10-13 21:45:00,160856.1,164354.04000000004
Buy,45,3590.32,2021-10-13 22:15:00,161564.4,2789.640000000043
Sell,45,3589.75,2021-10-13 22:30:00,161538.75,164328.39000000004
Buy,45,3607.35,2021-10-13 22:45:00,162330.75,1997.640000000043
Sell,45,3593.2,2021-10-13 23:00:00,161694.0,163691.64000000004
Buy,45,3593.2,2021-10-13 23:00:00,161694.0,1997.640000000043
Sell,45,3593.18,2021-10-13 23:15:00,161693.1,163690.74000000005
Buy,45,3623.32,2021-10-14 00:00:00,163049.4,641.3400000000547
Sell,45,3605.93,2021-10-14 00:15:00,162266.85,162908.19000000006
Buy,45,3605.93,2021-10-14 00:15:00,162266.85,641.3400000000547
Sell,45,3605.49,2021-10-14 00:30:00,162247.05,162888.39000000004
Buy,44,3649.79,2021-10-14 01:45:00,160590.76,2297.6300000000338
Sell,44,3649.02,2021-10-14 02:00:00,160556.88,162854.51000000004
Buy,44,3649.02,2021-10-14 02:00:00,160556.88,2297.6300000000338
Sell,44,3646.12,2021-10-14 02:15:00,160429.28,162726.91000000003
Buy,44,3644.15,2021-10-14 02:30:00,160342.6,2384.310000000027
Sell,44,3639.05,2021-10-14 02:45:00,160118.2,162502.51000000004
Buy,44,3638.52,2021-10-14 03:15:00,160094.88,2407.6300000000338
Sell,44,3638.45,2021-10-14 03:30:00,160091.8,162499.43000000002
Buy,44,3641.02,2021-10-14 04:00:00,160204.88,2294.5500000000175
Sell,44,3639.2,2021-10-14 04:15:00,160124.8,162419.35
Buy,44,3656.47,2021-10-14 04:45:00,160884.68,1534.6700000000128
Sell,44,3646.46,2021-10-14 05:00:00,160444.24,161978.91
Buy,44,3646.46,2021-10-14 05:00:00,160444.24,1534.6700000000128
Sell,44,3641.78,2021-10-14 05:15:00,160238.32,161772.99000000002
Buy,44,3644.5,2021-10-14 05:30:00,160358.0,1414.9900000000198
Sell,44,3638.8,2021-10-14 05:45:00,160107.2,161522.19000000003
Buy,44,3645.97,2021-10-14 06:00:00,160422.68,1099.5100000000384
Sell,44,3636.11,2021-10-14 06:15:00,159988.84,161088.35000000003
Buy,44,3636.11,2021-10-14 06:15:00,159988.84,1099.5100000000384
Sell,44,3632.0,2021-10-14 06:30:00,159808.0,160907.51000000004
Buy,44,3629.64,2021-10-14 06:45:00,159704.16,1203.350000000035
Sell,44,3627.48,2021-10-14 07:00:00,159609.12,160812.47000000003
Buy,44,3636.01,2021-10-14 07:30:00,159984.44,828.0300000000279
Sell,44,3632.8,2021-10-14 07:45:00,159843.2,160671.23000000004
Buy,44,3650.69,2021-10-14 08:15:00,160630.36000000002,40.87000000002445
Sell,44,3643.84,2021-10-14 08:30:00,160328.96000000002,160369.83000000005
Buy,43,3645.15,2021-10-14 09:00:00,156741.45,3628.3800000000338
Sell,43,3630.68,2021-10-14 09:15:00,156119.24,159747.62000000002
Buy,43,3630.68,2021-10-14 09:15:00,156119.24,3628.3800000000338
Sell,43,3635.31,2021-10-14 09:30:00,156318.33,159946.71000000002
Buy,43,3635.31,2021-10-14 09:30:00,156318.33,3628.3800000000338
Sell,43,3634.95,2021-10-14 09:45:00,156302.85,159931.23000000004
Buy,43,3641.81,2021-10-14 10:15:00,156597.83,3333.4000000000524
Sell,43,3641.96,2021-10-14 10:30:00,156604.28,159937.68000000005
Buy,43,3641.96,2021-10-14 10:30:00,156604.28,3333.4000000000524
Sell,43,3642.8,2021-10-14 10:45:00,156640.4,159973.80000000005
Buy,42,3739.46,2021-10-14 11:15:00,157057.32,2916.4800000000396
Sell,42,3746.0,2021-10-14 11:30:00,157332.0,160248.48000000004
Buy,42,3758.14,2021-10-14 12:00:00,157841.88,2406.600000000035
Sell,42,3749.46,2021-10-14 12:15:00,157477.32,159883.92000000004
Buy,42,3749.46,2021-10-14 12:15:00,157477.32,2406.600000000035
Sell,42,3743.26,2021-10-14 12:30:00,157216.92,159623.52000000005
Buy,42,3743.26,2021-10-14 12:30:00,157216.92,2406.600000000035
Sell,42,3739.68,2021-10-14 12:45:00,157066.56,159473.16000000003
Buy,42,3739.68,2021-10-14 12:45:00,157066.56,2406.600000000035
Sell,42,3736.58,2021-10-14 13:00:00,156936.36,159342.96000000002
Buy,42,3776.87,2021-10-14 13:30:00,158628.54,714.4200000000128
Sell,42,3771.02,2021-10-14 13:45:00,158382.84,159097.26
Buy,41,3797.5,2021-10-14 14:00:00,155697.5,3399.7600000000093
Sell,41,3789.38,2021-10-14 14:15:00,155364.58000000002,158764.34000000003
Buy,41,3789.38,2021-10-14 14:15:00,155364.58000000002,3399.7600000000093
Sell,41,3783.5,2021-10-14 14:30:00,155123.5,158523.26
Buy,41,3803.47,2021-10-14 16:00:00,155942.27,2580.99000000002
Sell,41,3791.38,2021-10-14 16:15:00,155446.58000000002,158027.57000000004
Buy,41,3787.07,2021-10-14 16:30:00,155269.87,2757.7000000000407
Sell,41,3787.01,2021-10-14 16:45:00,155267.41,158025.11000000004
Buy,41,3811.97,2021-10-14 17:15:00,156290.77,1734.3400000000547
Sell,41,3802.63,2021-10-14 17:30:00,155907.83000000002,157642.17000000007
Buy,41,3802.63,2021-10-14 17:30:00,155907.83000000002,1734.3400000000547
Sell,41,3794.46,2021-10-14 17:45:00,155572.86000000002,157307.20000000007
Buy,41,3794.46,2021-10-14 17:45:00,155572.86000000002,1734.3400000000547
Sell,41,3780.52,2021-10-14 18:00:00,155001.32,156735.66000000006
Buy,41,3780.52,2021-10-14 18:00:00,155001.32,1734.3400000000547
Sell,41,3763.02,2021-10-14 18:15:00,154283.82,156018.16000000006
Buy,41,3803.18,2021-10-14 18:45:00,155930.38,87.78000000005704
Sell,41,3780.12,2021-10-14 19:00:00,154984.91999999998,155072.70000000004
Buy,41,3780.12,2021-10-14 19:00:00,154984.91999999998,87.78000000005704
Sell,41,3772.03,2021-10-14 19:15:00,154653.23,154741.01000000007
Buy,40,3794.99,2021-10-14 19:45:00,151799.59999999998,2941.410000000091
Sell,40,3779.33,2021-10-14 20:00:00,151173.2,154114.6100000001
Buy,40,3779.33,2021-10-14 20:00:00,151173.2,2941.410000000091
Sell,40,3769.99,2021-10-14 20:15:00,150799.59999999998,153741.01000000007
Buy,40,3769.99,2021-10-14 20:15:00,150799.59999999998,2941.410000000091
Sell,40,3773.19,2021-10-14 20:30:00,150927.6,153869.0100000001
Buy,40,3773.19,2021-10-14 20:30:00,150927.6,2941.410000000091
Sell,40,3761.56,2021-10-14 20:45:00,150462.4,153403.81000000008
Buy,40,3761.56,2021-10-14 20:45:00,150462.4,2941.410000000091
Sell,40,3758.15,2021-10-14 21:00:00,150326.0,153267.4100000001
Buy,40,3774.07,2021-10-14 21:30:00,150962.80000000002,2304.6100000000733
Sell,40,3780.73,2021-10-14 21:45:00,151229.2,153533.81000000008
Buy,40,3780.73,2021-10-14 21:45:00,151229.2,2304.6100000000733
Sell,40,3774.86,2021-10-14 22:00:00,150994.4,153299.01000000007
Buy,40,3774.86,2021-10-14 22:00:00,150994.4,2304.6100000000733
Sell,40,3767.77,2021-10-14 22:15:00,150710.8,153015.41000000006
Buy,40,3794.21,2021-10-14 23:00:00,151768.4,1247.0100000000675
Sell,40,3775.52,2021-10-14 23:15:00,151020.8,152267.81000000006
Buy,40,3798.41,2021-10-14 23:30:00,151936.4,331.4100000000617
Sell,40,3794.19,2021-10-14 23:45:00,151767.6,152099.01000000007
Buy,40,3794.19,2021-10-14 23:45:00,151767.6,331.4100000000617
Sell,40,3791.29,2021-10-15 00:00:00,151651.6,151983.01000000007
Buy,40,3791.29,2021-10-15 00:00:00,151651.6,331.4100000000617
Sell,40,3770.81,2021-10-15 00:15:00,150832.4,151163.81000000006
Buy,40,3774.59,2021-10-15 00:30:00,150983.6,180.21000000005006
Sell,40,3769.72,2021-10-15 00:45:00,150788.8,150969.01000000004
Buy,40,3769.72,2021-10-15 00:45:00,150788.8,180.21000000005006
Sell,40,3759.63,2021-10-15 01:00:00,150385.2,150565.41000000006
Buy,40,3759.63,2021-10-15 01:00:00,150385.2,180.21000000005006
Sell,40,3753.26,2021-10-15 01:15:00,150130.40000000002,150310.61000000007
Buy,39,3758.28,2021-10-15 01:30:00,146572.92,3737.6900000000605
Sell,39,3752.13,2021-10-15 01:45:00,146333.07,150070.76000000007
Buy,39,3752.13,2021-10-15 01:45:00,146333.07,3737.6900000000605
Sell,39,3742.47,2021-10-15 02:00:00,145956.33,149694.02000000005
Buy,39,3835.54,2021-10-15 02:45:00,149586.06,107.96000000005006
Sell,39,3826.42,2021-10-15 03:00:00,149230.38,149338.34000000005
Buy,39,3826.42,2021-10-15 03:00:00,149230.38,107.96000000005006
Sell,39,3823.19,2021-10-15 03:15:00,149104.41,149212.37000000005
Buy,39,3824.07,2021-10-15 03:30:00,149138.73,73.64000000004307
Sell,39,3823.91,2021-10-15 03:45:00,149132.49,149206.13000000003
Buy,39,3823.91,2021-10-15 03:45:00,149132.49,73.64000000004307
Sell,39,3802.54,2021-10-15 04:00:00,148299.06,148372.70000000004
Buy,38,3815.36,2021-10-15 04:15:00,144983.68,3389.0200000000477
Sell,38,3806.04,2021-10-15 04:30:00,144629.52,148018.54000000004
Buy,38,3826.37,2021-10-15 05:00:00,145402.06,2616.4800000000396
Sell,38,3839.92,2021-10-15 05:15:00,145916.96,148533.44000000003
Buy,38,3847.63,2021-10-15 05:30:00,146209.94,2323.500000000029
Sell,38,3855.48,2021-10-15 05:45:00,146508.24,148831.74000000002
Buy,38,3855.48,2021-10-15 05:45:00,146508.24,2323.500000000029
Sell,38,3849.99,2021-10-15 06:00:00,146299.62,148623.12000000002
Buy,38,3849.99,2021-10-15 06:00:00,146299.62,2323.500000000029
Sell,38,3839.01,2021-10-15 06:15:00,145882.38,148205.88000000003
Buy,38,3839.01,2021-10-15 06:15:00,145882.38,2323.500000000029
Sell,38,3827.88,2021-10-15 06:30:00,145459.44,147782.94000000003
Buy,38,3831.06,2021-10-15 06:45:00,145580.28,2202.6600000000326
Sell,38,3821.55,2021-10-15 07:00:00,145218.9,147421.56000000003
Buy,38,3821.55,2021-10-15 07:00:00,145218.9,2202.6600000000326
Sell,38,3813.53,2021-10-15 07:15:00,144914.14,147116.80000000005
Buy,38,3820.75,2021-10-15 07:30:00,145188.5,1928.3000000000466
Sell,38,3809.27,2021-10-15 07:45:00,144752.26,146680.56000000006
Buy,38,3809.27,2021-10-15 07:45:00,144752.26,1928.3000000000466
Sell,38,3800.09,2021-10-15 08:00:00,144403.42,146331.72000000006
Buy,38,3800.09,2021-10-15 08:00:00,144403.42,1928.3000000000466
Sell,38,3773.12,2021-10-15 08:15:00,143378.56,145306.86000000004
Buy,38,3787.77,2021-10-15 08:30:00,143935.26,1371.600000000035
Sell,38,3769.03,2021-10-15 08:45:00,143223.14,144594.74000000005
Buy,38,3769.03,2021-10-15 08:45:00,143223.14,1371.600000000035
Sell,38,3763.99,2021-10-15 09:00:00,143031.62,144403.22000000003
Buy,38,3769.21,2021-10-15 09:15:00,143229.98,1173.2400000000198
Sell,38,3771.26,2021-10-15 09:30:00,143307.88,144481.12000000002
Buy,38,3785.55,2021-10-15 09:45:00,143850.9,630.2200000000303
Sell,38,3769.16,2021-10-15 10:00:00,143228.08,143858.30000000002
Buy,38,3769.16,2021-10-15 10:00:00,143228.08,630.2200000000303
Sell,38,3769.67,2021-10-15 10:15:00,143247.46,143877.68000000002
Buy,38,3769.67,2021-10-15 10:15:00,143247.46,630.2200000000303
Sell,38,3767.01,2021-10-15 10:30:00,143146.38,143776.60000000003
Buy,37,3794.77,2021-10-15 11:00:00,140406.49,3370.1100000000442
Sell,37,3790.19,2021-10-15 11:15:00,140237.03,143607.14000000004
Buy,37,3790.19,2021-10-15 11:15:00,140237.03,3370.1100000000442
Sell,37,3786.24,2021-10-15 11:30:00,140090.88,143460.99000000005
Buy,37,3786.24,2021-10-15 11:30:00,140090.88,3370.1100000000442
Sell,37,3780.95,2021-10-15 11:45:00,139895.15,143265.26000000004
Buy,37,3780.95,2021-10-15 11:45:00,139895.15,3370.1100000000442
Sell,37,3777.73,2021-10-15 12:00:00,139776.01,143146.12000000005
Buy,37,3783.9,2021-10-15 12:15:00,140004.30000000002,3141.820000000036
Sell,37,3782.65,2021-10-15 12:30:00,139958.05000000002,143099.87000000005
Buy,37,3782.65,2021-10-15 12:30:00,139958.05000000002,3141.820000000036
Sell,37,3771.27,2021-10-15 12:45:00,139536.99,142678.81000000003
Buy,37,3803.96,2021-10-15 13:15:00,140746.52,1932.2900000000373
Sell,37,3806.28,2021-10-15 13:30:00,140832.36000000002,142764.65000000005
Buy,37,3827.35,2021-10-15 14:00:00,141611.94999999998,1152.7000000000698
Sell,37,3805.52,2021-10-15 14:15:00,140804.24,141956.94000000006
Buy,37,3805.52,2021-10-15 14:15:00,140804.24,1152.7000000000698
Sell,37,3811.31,2021-10-15 14:30:00,141018.47,142171.17000000007
Buy,37,3811.01,2021-10-15 14:45:00,141007.37,1163.8000000000757
Sell,37,3802.57,2021-10-15 15:00:00,140695.09,141858.89000000007
Buy,37,3802.57,2021-10-15 15:00:00,140695.09,1163.8000000000757
Sell,37,3797.2,2021-10-15 15:15:00,140496.4,141660.20000000007
Buy,37,3797.2,2021-10-15 15:15:00,140496.4,1163.8000000000757
Sell,37,3797.99,2021-10-15 15:30:00,140525.63,141689.43000000008
Buy,37,3797.99,2021-10-15 15:30:00,140525.63,1163.8000000000757
Sell,37,3793.59,2021-10-15 15:45:00,140362.83000000002,141526.6300000001
Buy,36,3867.71,2021-10-15 16:45:00,139237.56,2289.0700000000943
Sell,36,3868.4,2021-10-15 17:00:00,139262.4,141551.4700000001
Buy,36,3868.4,2021-10-15 17:00:00,139262.4,2289.0700000000943
Sell,36,3859.17,2021-10-15 17:15:00,138930.12,141219.1900000001
Buy,36,3871.08,2021-10-15 17:30:00,139358.88,1860.310000000085
Sell,36,3860.15,2021-10-15 17:45:00,138965.4,140825.71000000008
Buy,36,3860.15,2021-10-15 17:45:00,138965.4,1860.310000000085
Sell,36,3863.83,2021-10-15 18:00:00,139097.88,140958.1900000001
Buy,36,3894.0,2021-10-15 18:15:00,140184.0,774.1900000000896
Sell,36,3891.48,2021-10-15 18:30:00,140093.28,140867.4700000001
Buy,36,3891.48,2021-10-15 18:30:00,140093.28,774.1900000000896
Sell,36,3883.45,2021-10-15 18:45:00,139804.19999999998,140578.39000000007
Buy,36,3883.45,2021-10-15 18:45:00,139804.19999999998,774.1900000000896
Sell,36,3858.33,2021-10-15 19:00:00,138899.88,139674.0700000001
Buy,36,3858.58,2021-10-15 19:15:00,138908.88,765.1900000000896
Sell,36,3847.09,2021-10-15 19:30:00,138495.24,139260.43000000008
Buy,36,3847.09,2021-10-15 19:30:00,138495.24,765.1900000000896
Sell,36,3851.65,2021-10-15 19:45:00,138659.4,139424.59000000008
Buy,35,3891.45,2021-10-15 20:15:00,136200.75,3223.840000000084
Sell,35,3887.01,2021-10-15 20:30:00,136045.35,139269.1900000001
Buy,35,3887.01,2021-10-15 20:30:00,136045.35,3223.840000000084
Sell,35,3884.77,2021-10-15 20:45:00,135966.95,139190.7900000001
Buy,35,3884.77,2021-10-15 20:45:00,135966.95,3223.840000000084
Sell,35,3873.81,2021-10-15 21:00:00,135583.35,138807.1900000001
Buy,35,3873.81,2021-10-15 21:00:00,135583.35,3223.840000000084
Sell,35,3853.3,2021-10-15 21:15:00,134865.5,138089.34000000008
Buy,35,3869.26,2021-10-15 21:30:00,135424.1,2665.240000000078
Sell,35,3843.15,2021-10-15 21:45:00,134510.25,137175.49000000008
Buy,35,3843.15,2021-10-15 21:45:00,134510.25,2665.240000000078
Sell,35,3842.23,2021-10-15 22:00:00,134478.05,137143.29000000007
Buy,35,3844.88,2021-10-15 22:15:00,134570.80000000002,2572.490000000049
Sell,35,3851.47,2021-10-15 22:30:00,134801.44999999998,137373.94000000003
Buy,35,3851.56,2021-10-15 22:45:00,134804.6,2569.3400000000256
Sell,35,3844.25,2021-10-15 23:00:00,134548.75,137118.09000000003
Buy,35,3866.12,2021-10-15 23:30:00,135314.19999999998,1803.890000000043
Sell,35,3872.71,2021-10-15 23:45:00,135544.85,137348.74000000005
Buy,35,3872.71,2021-10-15 23:45:00,135544.85,1803.890000000043
Sell,35,3857.75,2021-10-16 00:00:00,135021.25,136825.14000000004
Buy,35,3857.75,2021-10-16 00:00:00,135021.25,1803.890000000043
Sell,35,3858.07,2021-10-16 00:15:00,135032.45,136836.34000000005
Buy,35,3853.59,2021-10-16 00:30:00,134875.65,1960.6900000000605
Sell,35,3848.1,2021-10-16 00:45:00,134683.5,136644.19000000006
Buy,35,3852.01,2021-10-16 01:15:00,134820.35,1823.8400000000547
Sell,35,3832.37,2021-10-16 01:30:00,134132.94999999998,135956.79000000004
Buy,35,3838.61,2021-10-16 01:45:00,134351.35,1605.4400000000314
Sell,35,3831.49,2021-10-16 02:00:00,134102.15,135707.59000000003
Buy,35,3856.44,2021-10-16 02:45:00,134975.4,732.1900000000314
Sell,35,3847.62,2021-10-16 03:00:00,134666.69999999998,135398.89
Buy,35,3847.62,2021-10-16 03:00:00,134666.69999999998,732.1900000000314
Sell,35,3852.52,2021-10-16 03:15:00,134838.2,135570.39000000004
Buy,35,3852.52,2021-10-16 03:15:00,134838.2,732.1900000000314
Sell,35,3844.0,2021-10-16 03:30:00,134540.0,135272.19000000003
Buy,35,3844.0,2021-10-16 03:30:00,134540.0,732.1900000000314
Sell,35,3846.27,2021-10-16 03:45:00,134619.45,135351.64000000004
Buy,35,3859.03,2021-10-16 04:00:00,135066.05000000002,285.5900000000256
Sell,35,3848.47,2021-10-16 04:15:00,134696.44999999998,134982.04
Buy,35,3848.47,2021-10-16 04:15:00,134696.44999999998,285.5900000000256
Sell,35,3844.15,2021-10-16 04:30:00,134545.25,134830.84000000003
Buy,35,3844.15,2021-10-16 04:30:00,134545.25,285.5900000000256
Sell,35,3837.53,2021-10-16 04:45:00,134313.55000000002,134599.14000000004
Buy,34,3866.69,2021-10-16 05:15:00,131467.46,3131.680000000051
Sell,34,3856.62,2021-10-16 05:30:00,131125.08,134256.76000000004
Buy,34,3856.62,2021-10-16 05:30:00,131125.08,3131.680000000051
Sell,34,3857.99,2021-10-16 05:45:00,131171.66,134303.34000000005
Buy,34,3867.32,2021-10-16 06:15:00,131488.88,2814.46000000005
Sell,34,3856.8,2021-10-16 06:30:00,131131.2,133945.66000000006
Buy,34,3856.8,2021-10-16 06:30:00,131131.2,2814.46000000005
Sell,34,3850.28,2021-10-16 06:45:00,130909.52,133723.98000000004
Buy,34,3850.28,2021-10-16 06:45:00,130909.52,2814.4600000000355
Sell,34,3844.27,2021-10-16 07:00:00,130705.18,133519.64
Buy,34,3844.27,2021-10-16 07:00:00,130705.18,2814.460000000021
Sell,34,3846.55,2021-10-16 07:15:00,130782.70000000001,133597.16000000003
Buy,34,3924.8,2021-10-16 08:15:00,133443.2,153.96000000002095
Sell,34,3924.74,2021-10-16 08:30:00,133441.16,133595.12000000002
Buy,33,3945.09,2021-10-16 08:45:00,130187.97,3407.1500000000233
Sell,33,3938.28,2021-10-16 09:00:00,129963.24,133370.39
Buy,33,3938.28,2021-10-16 09:00:00,129963.24,3407.1500000000087
Sell,33,3933.01,2021-10-16 09:15:00,129789.33,133196.48
Buy,33,3933.01,2021-10-16 09:15:00,129789.33,3407.1500000000087
Sell,33,3927.21,2021-10-16 09:30:00,129597.93000000001,133005.08000000002
Buy,33,3943.19,2021-10-16 10:00:00,130125.27,2879.810000000012
Sell,33,3938.9,2021-10-16 10:15:00,129983.7,132863.51
Buy,33,3943.76,2021-10-16 10:45:00,130144.08,2719.4300000000076
Sell,33,3935.31,2021-10-16 11:00:00,129865.23,132584.66
Buy,33,3935.31,2021-10-16 11:00:00,129865.23,2719.4300000000076
Sell,33,3932.91,2021-10-16 11:15:00,129786.03,132505.46000000002
Buy,33,3932.91,2021-10-16 11:15:00,129786.03,2719.430000000022
Sell,33,3805.72,2021-10-16 11:30:00,125588.76,128308.19000000002
Buy,32,3962.15,2021-10-16 11:45:00,126788.8,1519.390000000014
Sell,32,3948.38,2021-10-16 12:00:00,126348.16,127867.55000000002
Buy,32,3948.38,2021-10-16 12:00:00,126348.16,1519.390000000014
Sell,32,3943.98,2021-10-16 12:15:00,126207.36,127726.75000000001
Buy,32,3943.98,2021-10-16 12:15:00,126207.36,1519.390000000014
Sell,32,3924.7,2021-10-16 12:30:00,125590.4,127109.79000000001
Buy,32,3924.7,2021-10-16 12:30:00,125590.4,1519.390000000014
Sell,32,3901.4,2021-10-16 12:45:00,124844.8,126364.19000000002
Buy,32,3901.4,2021-10-16 12:45:00,124844.8,1519.390000000014
Sell,32,3915.14,2021-10-16 13:00:00,125284.48,126803.87000000001
Buy,32,3919.0,2021-10-16 14:15:00,125408.0,1395.87000000001
Sell,32,3910.75,2021-10-16 14:30:00,125144.0,126539.87000000001
Buy,32,3910.75,2021-10-16 14:30:00,125144.0,1395.87000000001
Sell,32,3901.93,2021-10-16 14:45:00,124861.76,126257.63
Buy,32,3901.93,2021-10-16 14:45:00,124861.76,1395.87000000001
Sell,32,3896.63,2021-10-16 15:00:00,124692.16,126088.03000000001
Buy,32,3918.08,2021-10-16 15:30:00,125378.56,709.4700000000157
Sell,32,3911.38,2021-10-16 15:45:00,125164.16,125873.63000000002
Buy,32,3911.38,2021-10-16 15:45:00,125164.16,709.4700000000157
Sell,32,3910.65,2021-10-16 16:00:00,125140.8,125850.27000000002
Buy,32,3910.65,2021-10-16 16:00:00,125140.8,709.4700000000157
Sell,32,3894.58,2021-10-16 16:15:00,124626.56,125336.03000000001
Buy,32,3904.5,2021-10-16 16:30:00,124944.0,392.0300000000134
Sell,32,3805.72,2021-10-16 16:45:00,121783.04,122175.07
Buy,31,3853.58,2021-10-16 17:15:00,119460.98,2714.090000000011
Sell,31,3865.19,2021-10-16 17:30:00,119820.89,122534.98000000001
Buy,31,3872.62,2021-10-16 17:45:00,120051.22,2483.7600000000093
Sell,31,3866.27,2021-10-16 18:00:00,119854.37,122338.13
Buy,31,3867.02,2021-10-16 18:15:00,119877.62,2460.5100000000093
Sell,31,3863.94,2021-10-16 18:30:00,119782.14,122242.65000000001
Buy,31,3871.97,2021-10-16 18:45:00,120031.06999999999,2211.5800000000163
Sell,31,3863.71,2021-10-16 19:00:00,119775.01,121986.59000000001
Buy,31,3863.71,2021-10-16 19:00:00,119775.01,2211.5800000000163
Sell,31,3805.72,2021-10-16 19:15:00,117977.31999999999,120188.90000000001
Buy,31,3842.51,2021-10-16 19:45:00,119117.81000000001,1071.0899999999965
Sell,31,3815.0,2021-10-16 20:00:00,118265.0,119336.09
Buy,31,3839.07,2021-10-16 21:00:00,119011.17,324.91999999999825
Sell,31,3833.64,2021-10-16 21:15:00,118842.84,119167.76
Buy,31,3833.64,2021-10-16 21:15:00,118842.84,324.91999999999825
Sell,31,3829.89,2021-10-16 21:30:00,118726.59,119051.51
Buy,31,3829.89,2021-10-16 21:30:00,118726.59,324.91999999999825
Sell,31,3818.09,2021-10-16 21:45:00,118360.79000000001,118685.71
Buy,31,3818.09,2021-10-16 21:45:00,118360.79000000001,324.91999999999825
Sell,31,3814.11,2021-10-16 22:00:00,118237.41,118562.33
Buy,31,3814.11,2021-10-16 22:00:00,118237.41,324.91999999999825
Sell,31,3811.3,2021-10-16 22:15:00,118150.3,118475.22
Buy,30,3845.73,2021-10-16 23:15:00,115371.9,3103.320000000007
Sell,30,3847.39,2021-10-16 23:30:00,115421.7,118525.02
Buy,30,3847.39,2021-10-16 23:30:00,115421.7,3103.320000000007
Sell,30,3833.3,2021-10-16 23:45:00,114999.0,118102.32
Buy,30,3842.08,2021-10-17 00:00:00,115262.4,2839.920000000013
Sell,30,3820.0,2021-10-17 00:15:00,114600.0,117439.92000000001
Buy,30,3857.97,2021-10-17 01:15:00,115739.09999999999,1700.8200000000215
Sell,30,3858.88,2021-10-17 01:30:00,115766.40000000001,117467.22000000003
Buy,30,3858.88,2021-10-17 01:30:00,115766.40000000001,1700.8200000000215
Sell,30,3852.72,2021-10-17 01:45:00,115581.59999999999,117282.42000000001
Buy,30,3852.72,2021-10-17 01:45:00,115581.59999999999,1700.8200000000215
Sell,30,3856.0,2021-10-17 02:00:00,115680.0,117380.82000000002
Buy,30,3856.0,2021-10-17 02:00:00,115680.0,1700.8200000000215
Sell,30,3847.01,2021-10-17 02:15:00,115410.3,117111.12000000002
Buy,30,3847.01,2021-10-17 02:15:00,115410.3,1700.8200000000215
Sell,30,3847.94,2021-10-17 02:30:00,115438.2,117139.02000000002
Buy,30,3847.94,2021-10-17 02:30:00,115438.2,1700.8200000000215
Sell,30,3852.54,2021-10-17 02:45:00,115576.2,117277.02000000002
Buy,30,3886.09,2021-10-17 03:30:00,116582.70000000001,694.320000000007
Sell,30,3880.43,2021-10-17 03:45:00,116412.9,117107.22
Buy,29,3906.83,2021-10-17 04:00:00,113298.06999999999,3809.1500000000087
Sell,29,3894.1,2021-10-17 04:15:00,112928.9,116738.05
Buy,29,3894.1,2021-10-17 04:15:00,112928.9,3809.1500000000087
Sell,29,3886.7,2021-10-17 04:30:00,112714.29999999999,116523.45
Buy,30,3878.23,2021-10-17 04:45:00,116346.9,176.5500000000029
Sell,30,3886.0,2021-10-17 05:00:00,116580.0,116756.55
Buy,30,3886.0,2021-10-17 05:00:00,116580.0,176.5500000000029
Sell,30,3868.68,2021-10-17 05:15:00,116060.4,116236.95
Buy,30,3868.68,2021-10-17 05:15:00,116060.4,176.5500000000029
Sell,30,3870.62,2021-10-17 05:30:00,116118.59999999999,116295.15
Buy,30,3870.62,2021-10-17 05:30:00,116118.59999999999,176.5500000000029
Sell,30,3860.81,2021-10-17 05:45:00,115824.3,116000.85
Buy,30,3860.81,2021-10-17 05:45:00,115824.3,176.5500000000029
Sell,30,3865.31,2021-10-17 06:00:00,115959.3,116135.85
Buy,29,3885.68,2021-10-17 06:30:00,112684.72,3451.1300000000047
Sell,29,3878.05,2021-10-17 06:45:00,112463.45000000001,115914.58000000002
Buy,29,3910.0,2021-10-17 07:15:00,113390.0,2524.5800000000163
Sell,29,3894.99,2021-10-17 07:30:00,112954.70999999999,115479.29000000001
Buy,29,3894.99,2021-10-17 07:30:00,112954.70999999999,2524.5800000000163
Sell,29,3881.0,2021-10-17 07:45:00,112549.0,115073.58000000002
Buy,29,3901.07,2021-10-17 08:15:00,113131.03,1942.5500000000175
Sell,29,3895.4,2021-10-17 08:30:00,112966.6,114909.15000000002
Buy,29,3895.4,2021-10-17 08:30:00,112966.6,1942.5500000000175
Sell,29,3891.99,2021-10-17 08:45:00,112867.70999999999,114810.26000000001
Buy,29,3900.58,2021-10-17 09:15:00,113116.81999999999,1693.4400000000169
Sell,29,3898.28,2021-10-17 09:30:00,113050.12000000001,114743.56000000003
Buy,29,3898.28,2021-10-17 09:30:00,113050.12000000001,1693.4400000000169
Sell,29,3898.63,2021-10-17 09:45:00,113060.27,114753.71000000002
Buy,29,3898.63,2021-10-17 09:45:00,113060.27,1693.4400000000169
Sell,29,3898.04,2021-10-17 10:00:00,113043.16,114736.60000000002
Buy,29,3898.04,2021-10-17 10:00:00,113043.16,1693.4400000000169
Sell,29,3889.86,2021-10-17 10:15:00,112805.94,114499.38000000002
Buy,29,3889.86,2021-10-17 10:15:00,112805.94,1693.4400000000169
Sell,29,3891.5,2021-10-17 10:30:00,112853.5,114546.94000000002
Buy,29,3891.5,2021-10-17 10:30:00,112853.5,1693.4400000000169
Sell,29,3888.61,2021-10-17 10:45:00,112769.69,114463.13000000002
Buy,29,3893.2,2021-10-17 11:00:00,112902.79999999999,1560.3300000000309
Sell,29,3883.72,2021-10-17 11:15:00,112627.87999999999,114188.21000000002
Buy,29,3883.72,2021-10-17 11:15:00,112627.87999999999,1560.3300000000309
Sell,29,3878.65,2021-10-17 11:30:00,112480.85,114041.18000000004
Buy,29,3878.65,2021-10-17 11:30:00,112480.85,1560.3300000000309
Sell,29,3862.92,2021-10-17 11:45:00,112024.68000000001,113585.01000000004
Buy,29,3862.92,2021-10-17 11:45:00,112024.68000000001,1560.3300000000309
Sell,29,3849.03,2021-10-17 12:00:00,111621.87000000001,113182.20000000004
Buy,29,3852.78,2021-10-17 12:15:00,111730.62000000001,1451.5800000000309
Sell,29,3848.32,2021-10-17 12:30:00,111601.28,113052.86000000003
Buy,29,3876.1,2021-10-17 13:15:00,112406.9,645.9600000000355
Sell,29,3855.5,2021-10-17 13:30:00,111809.5,112455.46000000004
Buy,29,3864.68,2021-10-17 13:45:00,112075.72,379.74000000003434
Sell,29,3855.39,2021-10-17 14:00:00,111806.31,112186.05000000003
Buy,29,3855.39,2021-10-17 14:00:00,111806.31,379.74000000003434
Sell,29,3848.86,2021-10-17 14:15:00,111616.94,111996.68000000004
Buy,29,3860.29,2021-10-17 14:45:00,111948.41,48.27000000003318
Sell,29,3844.34,2021-10-17 15:00:00,111485.86,111534.13000000003
Buy,29,3844.34,2021-10-17 15:00:00,111485.86,48.27000000003318
Sell,29,3827.69,2021-10-17 15:15:00,111003.01,111051.28000000003
Buy,29,3827.69,2021-10-17 15:15:00,111003.01,48.27000000003318
Sell,29,3785.15,2021-10-17 15:30:00,109769.35,109817.62000000004
Buy,29,3785.15,2021-10-17 15:30:00,109769.35,48.27000000003318
Sell,29,3789.92,2021-10-17 15:45:00,109907.68000000001,109955.95000000004
Buy,29,3789.92,2021-10-17 15:45:00,109907.68000000001,48.27000000003318
Sell,29,3788.55,2021-10-17 16:00:00,109867.95000000001,109916.22000000004
Buy,28,3813.88,2021-10-17 16:45:00,106788.64,3127.5800000000454
Sell,28,3802.65,2021-10-17 17:00:00,106474.2,109601.78000000004
Buy,28,3802.65,2021-10-17 17:00:00,106474.2,3127.5800000000454
Sell,28,3807.51,2021-10-17 17:15:00,106610.28,109737.86000000004
Buy,28,3812.68,2021-10-17 17:30:00,106755.04,2982.8200000000506
Sell,28,3806.78,2021-10-17 17:45:00,106589.84000000001,109572.66000000006
Buy,28,3806.78,2021-10-17 17:45:00,106589.84000000001,2982.8200000000506
Sell,28,3809.48,2021-10-17 18:00:00,106665.44,109648.26000000005
Buy,28,3811.98,2021-10-17 18:15:00,106735.44,2912.8200000000506
Sell,28,3807.59,2021-10-17 18:30:00,106612.52,109525.34000000005
Buy,28,3813.5,2021-10-17 18:45:00,106778.0,2747.3400000000547
Sell,28,3796.35,2021-10-17 19:00:00,106297.8,109045.14000000006
Buy,28,3796.35,2021-10-17 19:00:00,106297.8,2747.3400000000547
Sell,28,3789.99,2021-10-17 19:15:00,106119.72,108867.06000000006
Buy,28,3789.99,2021-10-17 19:15:00,106119.72,2747.3400000000547
Sell,28,3774.48,2021-10-17 19:30:00,105685.44,108432.78000000006
Buy,28,3774.48,2021-10-17 19:30:00,105685.44,2747.3400000000547
Sell,28,3768.81,2021-10-17 19:45:00,105526.68,108274.02000000005
Buy,28,3768.81,2021-10-17 19:45:00,105526.68,2747.3400000000547
Sell,28,3738.17,2021-10-17 20:00:00,104668.76000000001,107416.10000000006
Buy,28,3738.17,2021-10-17 20:00:00,104668.76000000001,2747.3400000000547
Sell,28,3690.37,2021-10-17 20:15:00,103330.36,106077.70000000006
Buy,28,3705.63,2021-10-17 20:30:00,103757.64,2320.060000000056
Sell,28,3701.1,2021-10-17 20:45:00,103630.8,105950.86000000006
Buy,27,3805.0,2021-10-17 22:15:00,102735.0,3215.860000000059
Sell,27,3810.95,2021-10-17 22:30:00,102895.65,106111.51000000005
Buy,27,3830.0,2021-10-17 22:45:00,103410.0,2701.510000000053
Sell,27,3832.8,2021-10-17 23:00:00,103485.6,106187.11000000006
Buy,27,3832.8,2021-10-17 23:00:00,103485.6,2701.510000000053
Sell,27,3824.88,2021-10-17 23:15:00,103271.76000000001,105973.27000000006
Buy,27,3839.59,2021-10-17 23:30:00,103668.93000000001,2304.3400000000547
Sell,27,3851.01,2021-10-17 23:45:00,103977.27,106281.61000000006
Buy,27,3851.01,2021-10-17 23:45:00,103977.27,2304.3400000000547
Sell,27,3853.03,2021-10-18 00:00:00,104031.81000000001,106336.15000000007
Buy,27,3867.22,2021-10-18 00:15:00,104414.93999999999,1921.2100000000792
Sell,27,3887.99,2021-10-18 00:30:00,104975.73,106896.94000000008
Buy,27,3887.99,2021-10-18 00:30:00,104975.73,1921.2100000000792
Sell,27,3882.15,2021-10-18 00:45:00,104818.05,106739.26000000008
Buy,27,3882.15,2021-10-18 00:45:00,104818.05,1921.2100000000792
Sell,27,3873.01,2021-10-18 01:00:00,104571.27,106492.48000000008
Buy,27,3890.14,2021-10-18 01:30:00,105033.78,1458.7000000000844
Sell,27,3879.15,2021-10-18 01:45:00,104737.05,106195.75000000009
Buy,27,3879.15,2021-10-18 01:45:00,104737.05,1458.7000000000844
Sell,27,3876.4,2021-10-18 02:00:00,104662.8,106121.50000000009
Buy,27,3876.4,2021-10-18 02:00:00,104662.8,1458.7000000000844
Sell,27,3869.97,2021-10-18 02:15:00,104489.18999999999,105947.89000000007
Buy,27,3872.51,2021-10-18 02:30:00,104557.77,1390.120000000068
Sell,27,3865.0,2021-10-18 02:45:00,104355.0,105745.12000000007
Buy,27,3865.0,2021-10-18 02:45:00,104355.0,1390.120000000068
Sell,27,3864.52,2021-10-18 03:00:00,104342.04,105732.16000000006
Buy,27,3864.52,2021-10-18 03:00:00,104342.04,1390.120000000068
Sell,27,3862.5,2021-10-18 03:15:00,104287.5,105677.62000000007
Buy,27,3862.5,2021-10-18 03:15:00,104287.5,1390.120000000068
Sell,27,3839.15,2021-10-18 03:30:00,103657.05,105047.17000000007
Buy,27,3856.5,2021-10-18 03:45:00,104125.5,921.670000000071
Sell,27,3849.7,2021-10-18 04:00:00,103941.9,104863.57000000007
Buy,27,3849.7,2021-10-18 04:00:00,103941.9,921.670000000071
Sell,27,3850.0,2021-10-18 04:15:00,103950.0,104871.67000000007
Buy,27,3869.35,2021-10-18 05:00:00,104472.45,399.2200000000739
Sell,27,3866.36,2021-10-18 05:15:00,104391.72,104790.94000000008
Buy,26,3886.83,2021-10-18 06:00:00,101057.58,3733.3600000000733
Sell,26,3865.02,2021-10-18 06:15:00,100490.52,104223.88000000008
Buy,26,3865.02,2021-10-18 06:15:00,100490.52,3733.3600000000733
Sell,26,3875.95,2021-10-18 06:30:00,100774.7,104508.06000000007
Buy,26,3875.95,2021-10-18 06:30:00,100774.7,3733.3600000000733
Sell,26,3865.38,2021-10-18 06:45:00,100499.88,104233.24000000008
Buy,26,3865.38,2021-10-18 06:45:00,100499.88,3733.3600000000733
Sell,26,3871.25,2021-10-18 07:00:00,100652.5,104385.86000000007
Buy,26,3876.59,2021-10-18 07:15:00,100791.34,3594.520000000077
Sell,26,3860.15,2021-10-18 07:30:00,100363.90000000001,103958.42000000009
Buy,26,3860.15,2021-10-18 07:30:00,100363.90000000001,3594.520000000077
Sell,26,3840.85,2021-10-18 07:45:00,99862.09999999999,103456.62000000007
Buy,26,3840.85,2021-10-18 07:45:00,99862.09999999999,3594.520000000077
Sell,26,3826.7,2021-10-18 08:00:00,99494.2,103088.72000000007
Buy,26,3855.76,2021-10-18 08:15:00,100249.76000000001,2838.9600000000646
Sell,26,3826.72,2021-10-18 08:30:00,99494.72,102333.68000000007
Buy,26,3826.72,2021-10-18 08:30:00,99494.72,2838.9600000000646
Sell,26,3825.92,2021-10-18 08:45:00,99473.92,102312.88000000006
Buy,26,3840.35,2021-10-18 09:15:00,99849.09999999999,2463.7800000000716
Sell,26,3827.65,2021-10-18 09:30:00,99518.90000000001,101982.68000000008
Buy,26,3827.65,2021-10-18 09:30:00,99518.90000000001,2463.7800000000716
Sell,26,3801.79,2021-10-18 09:45:00,98846.54,101310.32000000007
Buy,26,3801.79,2021-10-18 09:45:00,98846.54,2463.7800000000716
Sell,26,3781.86,2021-10-18 10:00:00,98328.36,100792.14000000007
Buy,26,3781.86,2021-10-18 10:00:00,98328.36,2463.7800000000716
Sell,26,3778.37,2021-10-18 10:15:00,98237.62,100701.40000000007
Buy,26,3789.2,2021-10-18 10:45:00,98519.2,2182.20000000007
Sell,26,3787.65,2021-10-18 11:00:00,98478.90000000001,100661.10000000008
Buy,26,3787.65,2021-10-18 11:00:00,98478.90000000001,2182.20000000007
Sell,26,3781.55,2021-10-18 11:15:00,98320.3,100502.50000000007
Buy,26,3781.55,2021-10-18 11:15:00,98320.3,2182.20000000007
Sell,26,3744.27,2021-10-18 11:30:00,97351.02,99533.22000000007
Buy,26,3744.27,2021-10-18 11:30:00,97351.02,2182.20000000007
Sell,26,3747.68,2021-10-18 11:45:00,97439.68,99621.88000000006
Buy,26,3747.68,2021-10-18 11:45:00,97439.68,2182.20000000007
Sell,26,3738.51,2021-10-18 12:00:00,97201.26000000001,99383.46000000008
Buy,26,3738.51,2021-10-18 12:00:00,97201.26000000001,2182.20000000007
Sell,26,3737.68,2021-10-18 12:15:00,97179.68,99361.88000000006
Buy,26,3748.75,2021-10-18 12:30:00,97467.5,1894.3800000000629
Sell,26,3732.28,2021-10-18 12:45:00,97039.28,98933.66000000006
Buy,26,3732.28,2021-10-18 12:45:00,97039.28,1894.3800000000629
Sell,26,3717.96,2021-10-18 13:00:00,96666.96,98561.34000000007
Buy,26,3786.44,2021-10-18 13:30:00,98447.44,113.90000000006694
Sell,26,3805.9,2021-10-18 13:45:00,98953.40000000001,99067.30000000008
Buy,26,3805.9,2021-10-18 13:45:00,98953.40000000001,113.90000000006694
Sell,26,3817.31,2021-10-18 14:00:00,99250.06,99363.96000000006
Buy,26,3817.31,2021-10-18 14:00:00,99250.06,113.90000000006694
Sell,26,3809.99,2021-10-18 14:15:00,99059.73999999999,99173.64000000006
Buy,26,3809.99,2021-10-18 14:15:00,99059.73999999999,113.90000000006694
Sell,26,3786.03,2021-10-18 14:30:00,98436.78,98550.68000000007
Buy,26,3789.61,2021-10-18 14:45:00,98529.86,20.820000000065193
Sell,26,3770.0,2021-10-18 15:00:00,98020.0,98040.82000000007
Buy,26,3770.0,2021-10-18 15:00:00,98020.0,20.820000000065193
Sell,26,3744.53,2021-10-18 15:15:00,97357.78,97378.60000000006
Buy,25,3780.94,2021-10-18 16:00:00,94523.5,2855.100000000064
Sell,25,3748.62,2021-10-18 16:15:00,93715.5,96570.60000000006
Buy,25,3748.62,2021-10-18 16:15:00,93715.5,2855.100000000064
Sell,25,3733.0,2021-10-18 16:30:00,93325.0,96180.10000000006
Buy,25,3733.8,2021-10-18 16:45:00,93345.0,2835.100000000064
Sell,25,3733.56,2021-10-18 17:00:00,93339.0,96174.10000000006
Buy,25,3745.6,2021-10-18 17:30:00,93640.0,2534.100000000064
Sell,25,3732.91,2021-10-18 17:45:00,93322.75,95856.85000000006
Buy,25,3745.0,2021-10-18 18:15:00,93625.0,2231.850000000064
Sell,25,3738.58,2021-10-18 18:30:00,93464.5,95696.35000000006
Buy,25,3738.58,2021-10-18 18:30:00,93464.5,2231.850000000064
Sell,25,3733.01,2021-10-18 18:45:00,93325.25,95557.10000000006
Buy,25,3733.01,2021-10-18 18:45:00,93325.25,2231.850000000064
Sell,25,3711.99,2021-10-18 19:00:00,92799.75,95031.60000000006
Buy,25,3711.99,2021-10-18 19:00:00,92799.75,2231.850000000064
Sell,25,3711.91,2021-10-18 19:15:00,92797.75,95029.60000000006
Buy,25,3762.49,2021-10-18 20:00:00,94062.25,967.350000000064
Sell,25,3755.51,2021-10-18 20:15:00,93887.75,94855.10000000006
Buy,25,3755.51,2021-10-18 20:15:00,93887.75,967.350000000064
Sell,25,3748.82,2021-10-18 20:30:00,93720.5,94687.85000000006
Buy,25,3748.82,2021-10-18 20:30:00,93720.5,967.350000000064
Sell,25,3737.0,2021-10-18 20:45:00,93425.0,94392.35000000006
Buy,25,3737.0,2021-10-18 20:45:00,93425.0,967.350000000064
Sell,25,3735.34,2021-10-18 21:00:00,93383.5,94350.85000000006
Buy,25,3754.53,2021-10-18 21:30:00,93863.25,487.60000000006403
Sell,25,3748.04,2021-10-18 21:45:00,93701.0,94188.60000000006
Buy,25,3748.04,2021-10-18 21:45:00,93701.0,487.60000000006403
Sell,25,3737.03,2021-10-18 22:00:00,93425.75,93913.35000000006
Buy,25,3737.03,2021-10-18 22:00:00,93425.75,487.60000000006403
Sell,25,3722.54,2021-10-18 22:15:00,93063.5,93551.10000000006
Buy,25,3722.54,2021-10-18 22:15:00,93063.5,487.60000000006403
Sell,25,3724.38,2021-10-18 22:30:00,93109.5,93597.10000000006
Buy,24,3750.6,2021-10-18 22:45:00,90014.4,3582.70000000007
Sell,24,3744.59,2021-10-18 23:00:00,89870.16,93452.86000000007
Buy,24,3756.02,2021-10-18 23:30:00,90144.48,3308.3800000000774
Sell,24,3748.31,2021-10-18 23:45:00,89959.44,93267.82000000008
Buy,24,3768.79,2021-10-19 00:15:00,90450.95999999999,2816.860000000088
Sell,24,3761.96,2021-10-19 00:30:00,90287.04000000001,93103.9000000001
Buy,24,3761.96,2021-10-19 00:30:00,90287.04000000001,2816.860000000088
Sell,24,3753.69,2021-10-19 00:45:00,90088.56,92905.42000000009
Buy,24,3790.55,2021-10-19 01:15:00,90973.20000000001,1932.220000000074
Sell,24,3793.73,2021-10-19 01:30:00,91049.52,92981.74000000008
Buy,24,3793.73,2021-10-19 01:30:00,91049.52,1932.220000000074
Sell,24,3790.09,2021-10-19 01:45:00,90962.16,92894.38000000008
Buy,24,3804.0,2021-10-19 02:00:00,91296.0,1598.3800000000774
Sell,24,3793.34,2021-10-19 02:15:00,91040.16,92638.54000000008
Buy,24,3793.34,2021-10-19 02:15:00,91040.16,1598.3800000000774
Sell,24,3781.71,2021-10-19 02:30:00,90761.04000000001,92359.42000000009
Buy,24,3812.69,2021-10-19 03:00:00,91504.56,854.8600000000879
Sell,24,3817.74,2021-10-19 03:15:00,91625.76,92480.62000000008
Buy,24,3817.74,2021-10-19 03:15:00,91625.76,854.8600000000879
Sell,24,3812.66,2021-10-19 03:30:00,91503.84,92358.70000000008
Buy,24,3843.77,2021-10-19 04:15:00,92250.48,108.22000000008848
Sell,24,3830.81,2021-10-19 04:30:00,91939.44,92047.66000000009
Buy,24,3830.81,2021-10-19 04:30:00,91939.44,108.22000000008848
Sell,24,3820.78,2021-10-19 04:45:00,91698.72,91806.94000000009
Buy,24,3824.26,2021-10-19 05:00:00,91782.24,24.7000000000844
Sell,24,3819.59,2021-10-19 05:15:00,91670.16,91694.86000000009
Buy,24,3819.59,2021-10-19 05:15:00,91670.16,24.7000000000844
Sell,24,3825.78,2021-10-19 05:30:00,91818.72,91843.42000000009
Buy,24,3825.78,2021-10-19 05:30:00,91818.72,24.7000000000844
Sell,24,3823.33,2021-10-19 05:45:00,91759.92,91784.62000000008
Buy,24,3823.33,2021-10-19 05:45:00,91759.92,24.7000000000844
Sell,24,3808.25,2021-10-19 06:00:00,91398.0,91422.70000000008
Buy,23,3816.96,2021-10-19 06:15:00,87790.08,3632.6200000000827
Sell,23,3788.7,2021-10-19 06:30:00,87140.09999999999,90772.72000000007
Buy,23,3788.7,2021-10-19 06:30:00,87140.09999999999,3632.6200000000827
Sell,23,3791.26,2021-10-19 06:45:00,87198.98000000001,90831.6000000001
Buy,23,3789.0,2021-10-19 07:00:00,87147.0,3684.600000000093
Sell,23,3800.68,2021-10-19 07:15:00,87415.64,91100.24000000009
Buy,23,3811.53,2021-10-19 07:45:00,87665.19,3435.05000000009
Sell,23,3794.19,2021-10-19 08:00:00,87266.37,90701.42000000009
Buy,23,3794.19,2021-10-19 08:00:00,87266.37,3435.05000000009
Sell,23,3794.26,2021-10-19 08:15:00,87267.98000000001,90703.0300000001
Buy,23,3813.58,2021-10-19 08:45:00,87712.34,2990.690000000104
Sell,23,3786.17,2021-10-19 09:00:00,87081.91,90072.60000000011
Buy,23,3786.17,2021-10-19 09:00:00,87081.91,2990.690000000104
Sell,23,3792.99,2021-10-19 09:15:00,87238.76999999999,90229.4600000001
Buy,23,3793.33,2021-10-19 09:30:00,87246.59,2982.870000000097
Sell,23,3795.99,2021-10-19 09:45:00,87307.76999999999,90290.64000000009
Buy,23,3796.1,2021-10-19 10:00:00,87310.3,2980.340000000084
Sell,23,3799.08,2021-10-19 10:15:00,87378.84,90359.18000000008
Buy,23,3799.08,2021-10-19 10:15:00,87378.84,2980.340000000084
Sell,23,3795.57,2021-10-19 10:30:00,87298.11,90278.45000000008
Buy,23,3795.57,2021-10-19 10:30:00,87298.11,2980.340000000084
Sell,23,3794.2,2021-10-19 10:45:00,87266.59999999999,90246.94000000008
Buy,23,3794.2,2021-10-19 10:45:00,87266.59999999999,2980.340000000084
Sell,23,3787.75,2021-10-19 11:00:00,87118.25,90098.59000000008
Buy,23,3818.55,2021-10-19 11:30:00,87826.65000000001,2271.940000000075
Sell,23,3801.22,2021-10-19 11:45:00,87428.06,89700.00000000007
Buy,23,3808.24,2021-10-19 12:00:00,87589.51999999999,2110.4800000000832
Sell,23,3801.37,2021-10-19 12:15:00,87431.51,89541.99000000008
Buy,23,3818.51,2021-10-19 12:30:00,87825.73000000001,1716.2600000000675
Sell,23,3803.82,2021-10-19 12:45:00,87487.86,89204.12000000007
Buy,23,3803.82,2021-10-19 12:45:00,87487.86,1716.2600000000675
Sell,23,3809.49,2021-10-19 13:00:00,87618.26999999999,89334.53000000006
Buy,23,3817.27,2021-10-19 13:15:00,87797.21,1537.3200000000506
Sell,23,3803.8,2021-10-19 13:30:00,87487.40000000001,89024.72000000006
Buy,23,3813.82,2021-10-19 13:45:00,87717.86,1306.8600000000588
Sell,23,3808.85,2021-10-19 14:00:00,87603.55,88910.41000000006
Buy,23,3808.85,2021-10-19 14:00:00,87603.55,1306.8600000000588
Sell,23,3765.02,2021-10-19 14:15:00,86595.46,87902.32000000007
Buy,23,3804.04,2021-10-19 14:45:00,87492.92,409.40000000006694
Sell,23,3806.68,2021-10-19 15:00:00,87553.64,87963.04000000007
Buy,23,3799.14,2021-10-19 15:15:00,87380.22,582.8200000000652
Sell,23,3800.09,2021-10-19 15:30:00,87402.07,87984.89000000007
Buy,23,3800.09,2021-10-19 15:30:00,87402.07,582.8200000000652
Sell,23,3776.43,2021-10-19 15:45:00,86857.89,87440.71000000006
Buy,23,3776.43,2021-10-19 15:45:00,86857.89,582.8200000000652
Sell,23,3781.77,2021-10-19 16:00:00,86980.71,87563.53000000007
Buy,22,3821.19,2021-10-19 17:00:00,84066.18000000001,3497.350000000064
Sell,22,3813.35,2021-10-19 17:15:00,83893.7,87391.05000000006
Buy,22,3813.35,2021-10-19 17:15:00,83893.7,3497.350000000064
Sell,22,3809.51,2021-10-19 17:30:00,83809.22,87306.57000000007
Buy,22,3814.7,2021-10-19 17:45:00,83923.4,3383.170000000071
Sell,22,3801.01,2021-10-19 18:00:00,83622.22,87005.39000000007
Buy,22,3811.99,2021-10-19 18:30:00,83863.78,3141.6100000000733
Sell,22,3808.34,2021-10-19 18:45:00,83783.48000000001,86925.09000000008
Buy,22,3836.89,2021-10-19 19:15:00,84411.58,2513.510000000082
Sell,22,3819.02,2021-10-19 19:30:00,84018.44,86531.95000000008
Buy,22,3828.0,2021-10-19 20:00:00,84216.0,2315.9500000000844
Sell,22,3817.81,2021-10-19 20:15:00,83991.81999999999,86307.77000000008
Buy,22,3817.81,2021-10-19 20:15:00,83991.81999999999,2315.9500000000844
Sell,22,3816.62,2021-10-19 20:30:00,83965.64,86281.59000000008
Buy,22,3816.62,2021-10-19 20:30:00,83965.64,2315.9500000000844
Sell,22,3808.55,2021-10-19 20:45:00,83788.1,86104.05000000009
Buy,22,3820.65,2021-10-19 21:30:00,84054.3,2049.7500000000873
Sell,22,3814.81,2021-10-19 21:45:00,83925.81999999999,85975.57000000008
Buy,22,3883.28,2021-10-19 22:45:00,85432.16,543.4100000000763
Sell,22,3875.08,2021-10-19 23:00:00,85251.76,85795.17000000007
Buy,22,3875.08,2021-10-19 23:00:00,85251.76,543.4100000000763
Sell,22,3874.24,2021-10-19 23:15:00,85233.28,85776.69000000008
Buy,22,3890.36,2021-10-20 00:00:00,85587.92,188.77000000007683
Sell,22,3868.98,2021-10-20 00:15:00,85117.56,85306.33000000007
Buy,22,3868.98,2021-10-20 00:15:00,85117.56,188.77000000007683
Sell,22,3868.55,2021-10-20 00:30:00,85108.1,85296.87000000008
Buy,21,3885.16,2021-10-20 01:15:00,81588.36,3708.510000000082
Sell,21,3871.48,2021-10-20 01:30:00,81301.08,85009.59000000008
Buy,21,3871.48,2021-10-20 01:30:00,81301.08,3708.510000000082
Sell,21,3862.72,2021-10-20 01:45:00,81117.12,84825.63000000008
Buy,21,3862.72,2021-10-20 01:45:00,81117.12,3708.510000000082
Sell,21,3860.68,2021-10-20 02:00:00,81074.28,84782.79000000008
Buy,21,3856.97,2021-10-20 02:15:00,80996.37,3786.4200000000856
Sell,21,3846.25,2021-10-20 02:30:00,80771.25,84557.67000000009
Buy,21,3859.24,2021-10-20 03:15:00,81044.04,3513.630000000092
Sell,21,3857.4,2021-10-20 03:30:00,81005.40000000001,84519.0300000001
Buy,21,3857.4,2021-10-20 03:30:00,81005.40000000001,3513.630000000092
Sell,21,3848.11,2021-10-20 03:45:00,80810.31,84323.94000000009
Buy,21,3862.49,2021-10-20 05:00:00,81112.29,3211.650000000096
Sell,21,3857.81,2021-10-20 05:15:00,81014.01,84225.66000000009
Buy,21,3857.81,2021-10-20 05:15:00,81014.01,3211.650000000096
Sell,21,3845.47,2021-10-20 05:30:00,80754.87,83966.52000000009
Buy,21,3845.47,2021-10-20 05:30:00,80754.87,3211.650000000096
Sell,21,3843.91,2021-10-20 05:45:00,80722.11,83933.7600000001
Buy,21,3843.91,2021-10-20 05:45:00,80722.11,3211.650000000096
Sell,21,3847.38,2021-10-20 06:00:00,80794.98,84006.63000000009
Buy,21,3847.38,2021-10-20 06:00:00,80794.98,3211.650000000096
Sell,21,3832.97,2021-10-20 06:15:00,80492.37,83704.02000000009
Buy,21,3832.97,2021-10-20 06:15:00,80492.37,3211.650000000096
Sell,21,3837.31,2021-10-20 06:30:00,80583.51,83795.16000000009
Buy,21,3840.84,2021-10-20 06:45:00,80657.64,3137.5200000000914
Sell,21,3842.62,2021-10-20 07:00:00,80695.02,83832.5400000001
Buy,21,3853.72,2021-10-20 07:15:00,80928.12,2904.4200000001
Sell,21,3853.41,2021-10-20 07:30:00,80921.61,83826.0300000001
Buy,21,3853.41,2021-10-20 07:30:00,80921.61,2904.4200000001
Sell,21,3860.92,2021-10-20 07:45:00,81079.32,83983.7400000001
Buy,21,3858.99,2021-10-20 08:00:00,81038.79,2944.9500000001135
Sell,21,3865.09,2021-10-20 08:15:00,81166.89,84111.84000000011
Buy,21,3864.55,2021-10-20 08:30:00,81155.55,2956.29000000011
Sell,21,3853.3,2021-10-20 08:45:00,80919.3,83875.59000000011
Buy,21,3860.37,2021-10-20 09:00:00,81067.77,2807.820000000109
Sell,21,3854.99,2021-10-20 09:15:00,80954.79,83762.6100000001
Buy,21,3872.12,2021-10-20 09:45:00,81314.52,2448.0900000000984
Sell,21,3865.03,2021-10-20 10:00:00,81165.63,83613.7200000001
Buy,21,3865.03,2021-10-20 10:00:00,81165.63,2448.0900000000984
Sell,21,3855.14,2021-10-20 10:15:00,80957.94,83406.0300000001
Buy,21,3855.14,2021-10-20 10:15:00,80957.94,2448.0900000000984
Sell,21,3861.44,2021-10-20 10:30:00,81090.24,83538.3300000001
Buy,21,3861.44,2021-10-20 10:30:00,81090.24,2448.0900000000984
Sell,21,3857.54,2021-10-20 10:45:00,81008.34,83456.4300000001
Buy,21,3857.54,2021-10-20 10:45:00,81008.34,2448.0900000000984
Sell,21,3857.55,2021-10-20 11:00:00,81008.55,83456.6400000001
Buy,21,3857.55,2021-10-20 11:00:00,81008.55,2448.0900000000984
Sell,21,3861.59,2021-10-20 11:15:00,81093.39,83541.4800000001
Buy,21,3868.51,2021-10-20 11:30:00,81238.71,2302.7700000000914
Sell,21,3863.89,2021-10-20 11:45:00,81141.69,83444.4600000001
Buy,21,3950.29,2021-10-20 13:00:00,82956.09,488.3700000000972
Sell,21,3936.9,2021-10-20 13:15:00,82674.90000000001,83163.2700000001
Buy,20,3986.38,2021-10-20 13:30:00,79727.6,3435.6700000001
Sell,20,4012.86,2021-10-20 13:45:00,80257.2,83692.8700000001
Buy,20,4012.86,2021-10-20 13:45:00,80257.2,3435.6700000001
Sell,20,4015.13,2021-10-20 14:00:00,80302.6,83738.2700000001
Buy,20,4040.1,2021-10-20 14:15:00,80802.0,2936.270000000106
Sell,20,4055.89,2021-10-20 14:30:00,81117.8,84054.07000000011
Buy,20,4055.89,2021-10-20 14:30:00,81117.8,2936.270000000106
Sell,20,4054.57,2021-10-20 14:45:00,81091.40000000001,84027.67000000011
Buy,20,4047.96,2021-10-20 15:00:00,80959.2,3068.4700000001176
Sell,20,4043.71,2021-10-20 15:15:00,80874.2,83942.67000000011
Buy,20,4083.64,2021-10-20 15:45:00,81672.8,2269.8700000001118
Sell,20,4091.31,2021-10-20 16:00:00,81826.2,84096.07000000011
Buy,20,4091.31,2021-10-20 16:00:00,81826.2,2269.8700000001118
Sell,20,4093.55,2021-10-20 16:15:00,81871.0,84140.87000000011
Buy,20,4093.55,2021-10-20 16:15:00,81871.0,2269.8700000001118
Sell,20,4078.65,2021-10-20 16:30:00,81573.0,83842.87000000011
Buy,20,4078.65,2021-10-20 16:30:00,81573.0,2269.8700000001118
Sell,20,4082.93,2021-10-20 16:45:00,81658.59999999999,83928.4700000001
Buy,20,4082.93,2021-10-20 16:45:00,81658.59999999999,2269.8700000001118
Sell,20,4069.13,2021-10-20 17:00:00,81382.6,83652.47000000012
Buy,20,4084.63,2021-10-20 17:30:00,81692.6,1959.8700000001118
Sell,20,4081.2,2021-10-20 17:45:00,81624.0,83583.87000000011
Buy,20,4121.91,2021-10-20 18:30:00,82438.2,1145.6700000001147
Sell,20,4125.97,2021-10-20 18:45:00,82519.40000000001,83665.07000000012
Buy,20,4125.97,2021-10-20 18:45:00,82519.40000000001,1145.6700000001147
Sell,20,4126.43,2021-10-20 19:00:00,82528.6,83674.27000000012
Buy,20,4126.43,2021-10-20 19:00:00,82528.6,1145.6700000001147
Sell,20,4113.97,2021-10-20 19:15:00,82279.40000000001,83425.07000000012
Buy,20,4113.97,2021-10-20 19:15:00,82279.40000000001,1145.6700000001147
Sell,20,4104.72,2021-10-20 19:30:00,82094.40000000001,83240.07000000012
Buy,20,4104.62,2021-10-20 19:45:00,82092.4,1147.6700000001292
Sell,20,4100.72,2021-10-20 20:00:00,82014.40000000001,83162.07000000014
Buy,20,4100.72,2021-10-20 20:00:00,82014.40000000001,1147.6700000001292
Sell,20,4083.0,2021-10-20 20:15:00,81660.0,82807.67000000013
Buy,19,4145.13,2021-10-20 21:15:00,78757.47,4050.200000000128
Sell,19,4119.01,2021-10-20 21:30:00,78261.19,82311.39000000013
Buy,19,4119.01,2021-10-20 21:30:00,78261.19,4050.200000000128
Sell,19,4121.05,2021-10-20 21:45:00,78299.95,82350.15000000013
Buy,19,4127.35,2021-10-20 22:00:00,78419.65000000001,3930.5000000001164
Sell,19,4122.82,2021-10-20 22:15:00,78333.57999999999,82264.0800000001
Buy,19,4136.93,2021-10-20 22:30:00,78601.67000000001,3662.410000000091
Sell,19,4129.29,2021-10-20 22:45:00,78456.51,82118.92000000009
Buy,19,4152.96,2021-10-20 23:15:00,78906.24,3212.6800000000803
Sell,19,4155.91,2021-10-20 23:30:00,78962.29,82174.97000000007
Buy,19,4164.14,2021-10-20 23:45:00,79118.66,3056.3100000000704
Sell,19,4142.68,2021-10-21 00:00:00,78710.92000000001,81767.23000000008
Buy,19,4200.74,2021-10-21 00:15:00,79814.06,1953.1700000000856
Sell,19,4208.79,2021-10-21 00:30:00,79967.01,81920.18000000008
Buy,19,4208.79,2021-10-21 00:30:00,79967.01,1953.1700000000856
Sell,19,4193.7,2021-10-21 00:45:00,79680.3,81633.47000000009
Buy,19,4233.7,2021-10-21 01:00:00,80440.3,1193.1700000000856
Sell,19,4233.07,2021-10-21 01:15:00,80428.32999999999,81621.50000000007
Buy,19,4233.07,2021-10-21 01:15:00,80428.32999999999,1193.1700000000856
Sell,19,4219.42,2021-10-21 01:30:00,80168.98,81362.15000000008
Buy,19,4219.42,2021-10-21 01:30:00,80168.98,1193.1700000000856
Sell,19,4201.66,2021-10-21 01:45:00,79831.54,81024.71000000008
Buy,19,4204.26,2021-10-21 02:00:00,79880.94,1143.7700000000768
Sell,19,4187.7,2021-10-21 02:15:00,79566.3,80710.07000000008
Buy,19,4199.49,2021-10-21 02:45:00,79790.31,919.7600000000821
Sell,19,4179.05,2021-10-21 03:00:00,79401.95,80321.71000000008
Buy,19,4179.05,2021-10-21 03:00:00,79401.95,919.7600000000821
Sell,19,4159.7,2021-10-21 03:15:00,79034.3,79954.06000000008
Buy,19,4190.0,2021-10-21 03:45:00,79610.0,344.060000000085
Sell,19,4182.14,2021-10-21 04:00:00,79460.66,79804.72000000009
Buy,19,4182.14,2021-10-21 04:00:00,79460.66,344.060000000085
Sell,19,4163.2,2021-10-21 04:15:00,79100.8,79444.86000000009
Buy,19,4175.76,2021-10-21 04:30:00,79339.44,105.42000000008557
Sell,19,4173.63,2021-10-21 04:45:00,79298.97,79404.39000000009
Buy,19,4179.07,2021-10-21 05:15:00,79402.32999999999,2.060000000099535
Sell,19,4182.61,2021-10-21 05:30:00,79469.59,79471.6500000001
Buy,19,4178.71,2021-10-21 05:45:00,79395.49,76.1600000000908
Sell,19,4167.56,2021-10-21 06:00:00,79183.64000000001,79259.8000000001
Buy,19,4166.85,2021-10-21 06:15:00,79170.15000000001,89.65000000009604
Sell,19,4139.99,2021-10-21 06:30:00,78659.81,78749.4600000001
Buy,18,4161.15,2021-10-21 06:45:00,74900.7,3848.7600000000966
Sell,18,4153.24,2021-10-21 07:00:00,74758.31999999999,78607.08000000009
Buy,18,4173.12,2021-10-21 07:30:00,75116.16,3490.9200000000856
Sell,18,4166.52,2021-10-21 07:45:00,74997.36000000002,78488.2800000001
Buy,18,4188.23,2021-10-21 08:00:00,75388.13999999998,3100.140000000116
Sell,18,4184.6,2021-10-21 08:15:00,75322.8,78422.94000000012
Buy,18,4203.27,2021-10-21 08:30:00,75658.86000000002,2764.0800000001036
Sell,18,4200.02,2021-10-21 08:45:00,75600.36000000002,78364.44000000012
Buy,18,4234.66,2021-10-21 09:15:00,76223.88,2140.560000000114
Sell,18,4288.0,2021-10-21 09:30:00,77184.0,79324.56000000011
Buy,18,4306.69,2021-10-21 09:45:00,77520.42,1804.1400000001158
Sell,18,4298.83,2021-10-21 10:00:00,77378.94,79183.08000000012
Buy,18,4298.83,2021-10-21 10:00:00,77378.94,1804.1400000001158
Sell,18,4295.95,2021-10-21 10:15:00,77327.09999999999,79131.2400000001
Buy,18,4295.95,2021-10-21 10:15:00,77327.09999999999,1804.1400000001158
Sell,18,4310.0,2021-10-21 10:30:00,77580.0,79384.14000000012
Buy,18,4310.0,2021-10-21 10:30:00,77580.0,1804.1400000001158
Sell,18,4313.4,2021-10-21 10:45:00,77641.2,79445.34000000011
Buy,18,4330.6,2021-10-21 11:00:00,77950.8,1494.54000000011
Sell,18,4370.29,2021-10-21 11:15:00,78665.22,80159.76000000011
Buy,18,4370.29,2021-10-21 11:15:00,78665.22,1494.54000000011
Sell,18,4258.79,2021-10-21 11:30:00,76658.22,78152.76000000011
Buy,18,4262.94,2021-10-21 13:15:00,76732.92,1419.840000000113
Sell,18,4246.2,2021-10-21 13:30:00,76431.59999999999,77851.4400000001
Buy,18,4246.2,2021-10-21 13:30:00,76431.59999999999,1419.840000000113
Sell,18,4221.37,2021-10-21 13:45:00,75984.66,77404.50000000012
Buy,18,4221.37,2021-10-21 13:45:00,75984.66,1419.840000000113
Sell,18,4195.0,2021-10-21 14:00:00,75510.0,76929.84000000011
Buy,18,4139.74,2021-10-21 14:30:00,74515.31999999999,2414.5200000001205
Sell,18,4115.94,2021-10-21 14:45:00,74086.92,76501.44000000012
Buy,18,4115.94,2021-10-21 14:45:00,74086.92,2414.5200000001205
Sell,18,4112.67,2021-10-21 15:00:00,74028.06,76442.58000000012
Buy,18,4135.64,2021-10-21 16:15:00,74441.52,2001.060000000114
Sell,18,4103.99,2021-10-21 16:30:00,73871.81999999999,75872.8800000001
Buy,18,4093.57,2021-10-21 17:15:00,73684.26000000001,2188.620000000097
Sell,18,4075.43,2021-10-21 17:30:00,73357.73999999999,75546.36000000009
Buy,18,4075.43,2021-10-21 17:30:00,73357.73999999999,2188.620000000097
Sell,18,4049.62,2021-10-21 17:45:00,72893.16,75081.7800000001
Buy,18,4090.79,2021-10-21 18:00:00,73634.22,1447.5600000000995
Sell,18,4109.63,2021-10-21 18:15:00,73973.34,75420.9000000001
Buy,18,4109.63,2021-10-21 18:15:00,73973.34,1447.5600000000995
Sell,18,4080.49,2021-10-21 18:30:00,73448.81999999999,74896.38000000009
Buy,18,4080.49,2021-10-21 18:30:00,73448.81999999999,1447.5600000000995
Sell,18,4066.92,2021-10-21 18:45:00,73204.56,74652.1200000001
Buy,18,4114.0,2021-10-21 19:15:00,74052.0,600.1200000000972
Sell,18,4112.93,2021-10-21 19:30:00,74032.74,74632.8600000001
Buy,18,4112.93,2021-10-21 19:30:00,74032.74,600.1200000000972
Sell,18,4084.64,2021-10-21 19:45:00,73523.52,74123.6400000001
Buy,18,4084.64,2021-10-21 19:45:00,73523.52,600.1200000000972
Sell,18,4082.8,2021-10-21 20:00:00,73490.40000000001,74090.5200000001
Buy,18,4082.8,2021-10-21 20:00:00,73490.40000000001,600.1200000000972
Sell,18,4073.94,2021-10-21 20:15:00,73330.92,73931.0400000001
Buy,18,4073.94,2021-10-21 20:15:00,73330.92,600.1200000000972
Sell,18,4086.89,2021-10-21 20:30:00,73564.02,74164.1400000001
Buy,18,4119.04,2021-10-21 21:00:00,74142.72,21.420000000100117
Sell,18,4111.4,2021-10-21 21:15:00,74005.2,74026.6200000001
Buy,18,4111.4,2021-10-21 21:15:00,74005.2,21.420000000100117
Sell,18,4083.91,2021-10-21 21:30:00,73510.38,73531.8000000001
Buy,17,4095.86,2021-10-21 21:45:00,69629.62,3902.1800000001094
Sell,17,4104.26,2021-10-21 22:00:00,69772.42,73674.60000000011
Buy,17,4104.26,2021-10-21 22:00:00,69772.42,3902.1800000001094
Sell,17,4111.81,2021-10-21 22:15:00,69900.77,73802.95000000011
Buy,17,4111.81,2021-10-21 22:15:00,69900.77,3902.1800000001094
Sell,17,4080.73,2021-10-21 22:30:00,69372.41,73274.59000000011
Buy,17,4080.73,2021-10-21 22:30:00,69372.41,3902.1800000001094
Sell,17,4072.65,2021-10-21 22:45:00,69235.05,73137.23000000011
Buy,17,4087.14,2021-10-21 23:00:00,69481.38,3655.8500000001077
Sell,17,4061.84,2021-10-21 23:15:00,69051.28,72707.1300000001
Buy,17,4077.17,2021-10-21 23:30:00,69311.89,3395.240000000107
Sell,17,4057.26,2021-10-21 23:45:00,68973.42,72368.6600000001
Buy,17,4145.05,2021-10-22 01:00:00,70465.85,1902.8100000000995
Sell,17,4143.84,2021-10-22 01:15:00,70445.28,72348.0900000001
Buy,17,4143.84,2021-10-22 01:15:00,70445.28,1902.8100000000995
Sell,17,4127.08,2021-10-22 01:30:00,70160.36,72063.1700000001
Buy,17,4127.08,2021-10-22 01:30:00,70160.36,1902.8100000000995
Sell,17,4107.45,2021-10-22 01:45:00,69826.65,71729.4600000001
Buy,17,4124.99,2021-10-22 02:00:00,70124.83,1604.630000000092
Sell,17,4130.04,2021-10-22 02:15:00,70210.68,71815.31000000008
Buy,17,4130.04,2021-10-22 02:15:00,70210.68,1604.630000000092
Sell,17,4115.82,2021-10-22 02:30:00,69968.94,71573.5700000001
Buy,17,4115.82,2021-10-22 02:30:00,69968.94,1604.630000000092
Sell,17,4116.19,2021-10-22 02:45:00,69975.23,71579.86000000009
Buy,17,4161.86,2021-10-22 03:30:00,70751.62,828.2400000000926
Sell,17,4160.04,2021-10-22 03:45:00,70720.68,71548.92000000009
Buy,17,4160.04,2021-10-22 03:45:00,70720.68,828.2400000000926
Sell,17,4158.82,2021-10-22 04:00:00,70699.94,71528.1800000001
Buy,17,4158.82,2021-10-22 04:00:00,70699.94,828.2400000000926
Sell,17,4149.74,2021-10-22 04:15:00,70545.58,71373.8200000001
Buy,17,4149.74,2021-10-22 04:15:00,70545.58,828.2400000000926
Sell,17,4147.55,2021-10-22 04:30:00,70508.35,71336.5900000001
Buy,17,4153.11,2021-10-22 04:45:00,70602.87,733.720000000103
Sell,17,4146.72,2021-10-22 05:00:00,70494.24,71227.96000000011
Buy,17,4146.72,2021-10-22 05:00:00,70494.24,733.720000000103
Sell,17,4128.71,2021-10-22 05:15:00,70188.07,70921.79000000011
Buy,17,4135.56,2021-10-22 05:30:00,70304.52,617.2700000001059
Sell,17,4134.61,2021-10-22 05:45:00,70288.37,70905.6400000001
Buy,17,4141.02,2021-10-22 06:00:00,70397.34000000001,508.3000000000902
Sell,17,4116.68,2021-10-22 06:15:00,69983.56,70491.86000000009
Buy,17,4116.68,2021-10-22 06:15:00,69983.56,508.3000000000902
Sell,17,4114.99,2021-10-22 06:30:00,69954.83,70463.13000000009
Buy,17,4121.86,2021-10-22 06:45:00,70071.62,391.5100000000966
Sell,17,4116.18,2021-10-22 07:00:00,69975.06,70366.5700000001
Buy,16,4146.77,2021-10-22 07:30:00,66348.32,4018.2500000000873
Sell,16,4147.35,2021-10-22 07:45:00,66357.6,70375.8500000001
Buy,16,4156.91,2021-10-22 08:00:00,66510.56,3865.2900000000955
Sell,16,4141.65,2021-10-22 08:15:00,66266.4,70131.69000000009
Buy,16,4141.65,2021-10-22 08:15:00,66266.4,3865.2900000000955
Sell,16,4149.36,2021-10-22 08:30:00,66389.76,70255.05000000009
Buy,16,4148.92,2021-10-22 08:45:00,66382.72,3872.330000000089
Sell,16,4137.83,2021-10-22 09:00:00,66205.28,70077.61000000009
Buy,16,4137.83,2021-10-22 09:00:00,66205.28,3872.330000000089
Sell,16,4134.44,2021-10-22 09:15:00,66151.04,70023.37000000008
Buy,16,4134.44,2021-10-22 09:15:00,66151.04,3872.330000000089
Sell,16,4126.84,2021-10-22 09:30:00,66029.44,69901.77000000009
Buy,16,4126.84,2021-10-22 09:30:00,66029.44,3872.330000000089
Sell,16,4125.05,2021-10-22 09:45:00,66000.8,69873.13000000009
Buy,16,4125.05,2021-10-22 09:45:00,66000.8,3872.330000000089
Sell,16,4121.67,2021-10-22 10:00:00,65946.72,69819.05000000009
Buy,16,4121.67,2021-10-22 10:00:00,65946.72,3872.330000000089
Sell,16,4097.54,2021-10-22 10:15:00,65560.64,69432.97000000009
Buy,16,4125.24,2021-10-22 11:15:00,66003.84,3429.130000000092
Sell,16,4122.5,2021-10-22 11:30:00,65960.0,69389.13000000009
Buy,16,4122.5,2021-10-22 11:30:00,65960.0,3429.130000000092
Sell,16,4127.96,2021-10-22 11:45:00,66047.36,69476.49000000009
Buy,16,4127.96,2021-10-22 11:45:00,66047.36,3429.130000000092
Sell,16,4117.52,2021-10-22 12:00:00,65880.32,69309.4500000001
Buy,16,4142.25,2021-10-22 12:45:00,66276.0,3033.450000000099
Sell,16,4131.86,2021-10-22 13:00:00,66109.76,69143.2100000001
Buy,16,4131.86,2021-10-22 13:00:00,66109.76,3033.450000000099
Sell,16,4116.87,2021-10-22 13:15:00,65869.92,68903.3700000001
Buy,16,4116.87,2021-10-22 13:15:00,65869.92,3033.450000000099
Sell,16,4108.8,2021-10-22 13:30:00,65740.8,68774.2500000001
Buy,16,4108.8,2021-10-22 13:30:00,65740.8,3033.450000000099
Sell,16,4068.48,2021-10-22 13:45:00,65095.68,68129.13000000009
Buy,16,4068.48,2021-10-22 13:45:00,65095.68,3033.4500000000917
Sell,16,4044.15,2021-10-22 14:00:00,64706.4,67739.8500000001
Buy,16,4044.15,2021-10-22 14:00:00,64706.4,3033.4500000000917
Sell,16,4026.31,2021-10-22 14:15:00,64420.96,67454.41000000009
Buy,16,4026.31,2021-10-22 14:15:00,64420.96,3033.4500000000917
Sell,16,4005.92,2021-10-22 14:30:00,64094.72,67128.1700000001
Buy,16,4029.95,2021-10-22 14:45:00,64479.2,2648.970000000103
Sell,16,4027.19,2021-10-22 15:00:00,64435.04,67084.0100000001
Buy,16,4027.19,2021-10-22 15:00:00,64435.04,2648.9700000000958
Sell,16,3979.8,2021-10-22 15:15:00,63676.8,66325.7700000001
Buy,16,3994.09,2021-10-22 15:30:00,63905.44,2420.3300000001036
Sell,16,3970.05,2021-10-22 15:45:00,63520.8,65941.1300000001
Buy,16,3970.05,2021-10-22 15:45:00,63520.8,2420.3300000001036
Sell,16,3915.19,2021-10-22 16:00:00,62643.04,65063.370000000104
Buy,16,3988.53,2021-10-22 16:30:00,63816.48,1246.8900000001013
Sell,16,3975.38,2021-10-22 16:45:00,63606.08,64852.9700000001
Buy,16,3975.38,2021-10-22 16:45:00,63606.08,1246.8900000001013
Sell,16,3974.49,2021-10-22 17:00:00,63591.84,64838.7300000001
Buy,16,3974.49,2021-10-22 17:00:00,63591.84,1246.8900000001013
Sell,16,3950.56,2021-10-22 17:15:00,63208.96,64455.8500000001
Buy,16,3954.91,2021-10-22 17:30:00,63278.56,1177.2900000001027
Sell,16,3941.09,2021-10-22 17:45:00,63057.44,64234.730000000105
Buy,16,3941.09,2021-10-22 17:45:00,63057.44,1177.2900000001027
Sell,16,3936.0,2021-10-22 18:00:00,62976.0,64153.2900000001
Buy,16,3970.92,2021-10-22 18:30:00,63534.72,618.5700000001016
Sell,16,3961.95,2021-10-22 18:45:00,63391.2,64009.7700000001
Buy,16,3961.95,2021-10-22 18:45:00,63391.2,618.5700000001016
Sell,16,3946.9,2021-10-22 19:00:00,63150.4,63768.9700000001
Buy,16,3971.83,2021-10-22 19:15:00,63549.28,219.6900000001042
Sell,16,3959.55,2021-10-22 19:30:00,63352.8,63572.49000000011
Buy,15,3998.8,2021-10-22 20:00:00,59982.0,3590.490000000107
Sell,15,3990.85,2021-10-22 20:15:00,59862.75,63453.24000000011
Buy,15,3990.85,2021-10-22 20:15:00,59862.75,3590.490000000107
Sell,15,3996.38,2021-10-22 20:30:00,59945.700000000004,63536.19000000011
Buy,15,3996.38,2021-10-22 20:30:00,59945.700000000004,3590.490000000107
Sell,15,3980.01,2021-10-22 20:45:00,59700.15,63290.64000000011
Buy,15,3980.01,2021-10-22 20:45:00,59700.15,3590.490000000107
Sell,15,3976.65,2021-10-22 21:00:00,59649.75,63240.24000000011
Buy,15,3976.65,2021-10-22 21:00:00,59649.75,3590.490000000107
Sell,15,3968.99,2021-10-22 21:15:00,59534.85,63125.340000000106
Buy,15,3968.99,2021-10-22 21:15:00,59534.85,3590.490000000107
Sell,15,3967.41,2021-10-22 21:30:00,59511.149999999994,63101.6400000001
Buy,15,3967.41,2021-10-22 21:30:00,59511.149999999994,3590.490000000107
Sell,15,3952.68,2021-10-22 21:45:00,59290.2,62880.690000000104
Buy,15,3952.68,2021-10-22 21:45:00,59290.2,3590.490000000107
Sell,15,3952.84,2021-10-22 22:00:00,59292.600000000006,62883.09000000011
Buy,15,3973.16,2021-10-22 22:45:00,59597.399999999994,3285.6900000001187
Sell,15,3979.18,2021-10-22 23:00:00,59687.7,62973.390000000116
Buy,15,3984.54,2021-10-22 23:15:00,59768.1,3205.2900000001173
Sell,15,3978.87,2021-10-22 23:30:00,59683.049999999996,62888.34000000011
Buy,15,3978.87,2021-10-22 23:30:00,59683.049999999996,3205.2900000001173
Sell,15,3975.56,2021-10-22 23:45:00,59633.4,62838.69000000012
Buy,15,3975.56,2021-10-22 23:45:00,59633.4,3205.2900000001173
Sell,15,3958.85,2021-10-23 00:00:00,59382.75,62588.04000000012
Buy,15,4005.18,2021-10-23 00:45:00,60077.7,2510.34000000012
Sell,15,4005.39,2021-10-23 01:00:00,60080.85,62591.19000000012
Buy,15,4005.39,2021-10-23 01:00:00,60080.85,2510.34000000012
Sell,15,4002.41,2021-10-23 01:15:00,60036.149999999994,62546.490000000114
Buy,15,4002.41,2021-10-23 01:15:00,60036.149999999994,2510.34000000012
Sell,15,4000.69,2021-10-23 01:30:00,60010.35,62520.69000000012
Buy,15,4011.54,2021-10-23 01:45:00,60173.1,2347.59000000012
Sell,15,4017.09,2021-10-23 02:00:00,60256.350000000006,62603.940000000126
Buy,15,4017.09,2021-10-23 02:00:00,60256.350000000006,2347.59000000012
Sell,15,4018.93,2021-10-23 02:15:00,60283.95,62631.54000000012
Buy,15,4027.53,2021-10-23 02:30:00,60412.950000000004,2218.590000000113
Sell,15,4030.62,2021-10-23 02:45:00,60459.299999999996,62677.89000000011
Buy,15,4030.62,2021-10-23 02:45:00,60459.299999999996,2218.590000000113
Sell,15,4028.46,2021-10-23 03:00:00,60426.9,62645.490000000114
Buy,15,4028.46,2021-10-23 03:00:00,60426.9,2218.590000000113
Sell,15,4024.5,2021-10-23 03:15:00,60367.5,62586.09000000011
Buy,15,4031.19,2021-10-23 03:30:00,60467.85,2118.2400000001144
Sell,15,4025.96,2021-10-23 03:45:00,60389.4,62507.640000000116
Buy,15,4044.74,2021-10-23 04:00:00,60671.1,1836.5400000001173
Sell,15,4053.59,2021-10-23 04:15:00,60803.850000000006,62640.39000000012
Buy,15,4053.59,2021-10-23 04:15:00,60803.850000000006,1836.5400000001173
Sell,15,4034.58,2021-10-23 04:30:00,60518.7,62355.240000000114
Buy,15,4034.58,2021-10-23 04:30:00,60518.7,1836.5400000001173
Sell,15,4039.14,2021-10-23 04:45:00,60587.1,62423.640000000116
Buy,15,4039.14,2021-10-23 04:45:00,60587.1,1836.5400000001173
Sell,15,4023.39,2021-10-23 05:00:00,60350.85,62187.390000000116
Buy,15,4023.39,2021-10-23 05:00:00,60350.85,1836.5400000001173
Sell,15,4022.0,2021-10-23 05:15:00,60330.0,62166.54000000012
Buy,15,4022.88,2021-10-23 05:30:00,60343.200000000004,1823.340000000113
Sell,15,4013.81,2021-10-23 05:45:00,60207.15,62030.490000000114
Buy,15,4013.81,2021-10-23 05:45:00,60207.15,1823.340000000113
Sell,15,4008.22,2021-10-23 06:00:00,60123.299999999996,61946.64000000011
Buy,15,4031.45,2021-10-23 06:30:00,60471.75,1474.8900000001086
Sell,15,4032.4,2021-10-23 06:45:00,60486.0,61960.89000000011
Buy,15,4032.4,2021-10-23 06:45:00,60486.0,1474.8900000001086
Sell,15,4023.0,2021-10-23 07:00:00,60345.0,61819.89000000011
Buy,15,4023.0,2021-10-23 07:00:00,60345.0,1474.8900000001086
Sell,15,4012.88,2021-10-23 07:15:00,60193.200000000004,61668.09000000011
Buy,15,4012.88,2021-10-23 07:15:00,60193.200000000004,1474.8900000001086
Sell,15,4012.94,2021-10-23 07:30:00,60194.1,61668.99000000011
Buy,15,4030.34,2021-10-23 08:15:00,60455.100000000006,1213.8900000001013
Sell,15,4018.09,2021-10-23 08:30:00,60271.350000000006,61485.24000000011
Buy,15,4026.66,2021-10-23 08:45:00,60399.899999999994,1085.340000000113
Sell,15,4010.0,2021-10-23 09:00:00,60150.0,61235.34000000011
Buy,15,4010.0,2021-10-23 09:00:00,60150.0,1085.340000000113
Sell,15,3989.8,2021-10-23 09:15:00,59847.0,60932.34000000011
Buy,15,4001.0,2021-10-23 09:45:00,60015.0,917.3400000001129
Sell,15,3993.53,2021-10-23 10:00:00,59902.950000000004,60820.29000000012
Buy,15,3993.53,2021-10-23 10:00:00,59902.950000000004,917.3400000001129
Sell,15,3985.98,2021-10-23 10:15:00,59789.7,60707.04000000011
Buy,15,3985.98,2021-10-23 10:15:00,59789.7,917.3400000001129
Sell,15,3976.2,2021-10-23 10:30:00,59643.0,60560.34000000011
Buy,15,3976.2,2021-10-23 10:30:00,59643.0,917.3400000001129
Sell,15,3958.84,2021-10-23 10:45:00,59382.600000000006,60299.94000000012
Buy,14,4048.71,2021-10-23 11:30:00,56681.94,3618.0000000001164
Sell,14,4042.96,2021-10-23 11:45:00,56601.44,60219.44000000012
Buy,14,4042.96,2021-10-23 11:45:00,56601.44,3618.0000000001164
Sell,14,4036.16,2021-10-23 12:00:00,56506.24,60124.240000000114
Buy,14,4049.82,2021-10-23 12:30:00,56697.48,3426.760000000111
Sell,14,4042.55,2021-10-23 12:45:00,56595.700000000004,60022.460000000116
Buy,14,4042.55,2021-10-23 12:45:00,56595.700000000004,3426.760000000111
Sell,14,4031.86,2021-10-23 13:00:00,56446.04,59872.80000000011
Buy,14,4031.86,2021-10-23 13:00:00,56446.04,3426.760000000111
Sell,14,4028.87,2021-10-23 13:15:00,56404.18,59830.94000000011
Buy,14,4028.87,2021-10-23 13:15:00,56404.18,3426.760000000111
Sell,14,4029.67,2021-10-23 13:30:00,56415.380000000005,59842.140000000116
Buy,14,4031.1,2021-10-23 13:45:00,56435.4,3406.7400000001144
Sell,14,4030.43,2021-10-23 14:00:00,56426.02,59832.76000000011
Buy,14,4030.43,2021-10-23 14:00:00,56426.02,3406.7400000001144
Sell,14,4023.83,2021-10-23 14:15:00,56333.619999999995,59740.36000000011
Buy,14,4033.32,2021-10-23 14:30:00,56466.48,3273.8800000001065
Sell,14,4027.21,2021-10-23 14:45:00,56380.94,59654.82000000011
Buy,14,4094.09,2021-10-23 15:15:00,57317.26,2337.560000000107
Sell,14,4064.0,2021-10-23 15:30:00,56896.0,59233.56000000011
Buy,14,4112.24,2021-10-23 16:00:00,57571.36,1662.2000000001062
Sell,14,4108.5,2021-10-23 16:15:00,57519.0,59181.200000000106
Buy,14,4108.5,2021-10-23 16:15:00,57519.0,1662.2000000001062
Sell,14,4085.11,2021-10-23 16:30:00,57191.54,58853.74000000011
Buy,14,4085.11,2021-10-23 16:30:00,57191.54,1662.2000000001062
Sell,14,4089.33,2021-10-23 16:45:00,57250.619999999995,58912.8200000001
Buy,14,4112.58,2021-10-23 18:00:00,57576.119999999995,1336.7000000001062
Sell,14,4112.28,2021-10-23 18:15:00,57571.92,58908.620000000104
Buy,14,4112.28,2021-10-23 18:15:00,57571.92,1336.7000000001062
Sell,14,4106.01,2021-10-23 18:30:00,57484.14,58820.840000000106
Buy,14,4115.7,2021-10-23 18:45:00,57619.799999999996,1201.04000000011
Sell,14,4102.7,2021-10-23 19:00:00,57437.799999999996,58638.840000000106
Buy,14,4102.7,2021-10-23 19:00:00,57437.799999999996,1201.04000000011
Sell,14,4093.77,2021-10-23 19:15:00,57312.78,58513.82000000011
Buy,14,4091.03,2021-10-23 19:30:00,57274.420000000006,1239.4000000001033
Sell,14,4086.51,2021-10-23 19:45:00,57211.14,58450.5400000001
Buy,14,4086.51,2021-10-23 19:45:00,57211.14,1239.4000000001033
Sell,14,4087.11,2021-10-23 20:00:00,57219.54,58458.940000000104
Buy,14,4087.11,2021-10-23 20:00:00,57219.54,1239.4000000001033
Sell,14,4082.85,2021-10-23 20:15:00,57159.9,58399.300000000105
Buy,14,4082.85,2021-10-23 20:15:00,57159.9,1239.4000000001033
Sell,14,4080.14,2021-10-23 20:30:00,57121.96,58361.3600000001
Buy,14,4095.73,2021-10-23 21:00:00,57340.22,1021.1400000001013
Sell,14,4095.19,2021-10-23 21:15:00,57332.66,58353.800000000105
Buy,14,4107.19,2021-10-23 21:30:00,57500.659999999996,853.1400000001086
Sell,14,4093.14,2021-10-23 21:45:00,57303.96,58157.10000000011
Buy,14,4123.75,2021-10-23 22:00:00,57732.5,424.6000000001077
Sell,14,4125.54,2021-10-23 22:15:00,57757.56,58182.160000000105
Buy,14,4125.54,2021-10-23 22:15:00,57757.56,424.6000000001077
Sell,14,4118.76,2021-10-23 22:30:00,57662.64,58087.24000000011
Buy,13,4176.67,2021-10-23 23:15:00,54296.71,3790.530000000108
Sell,13,4154.16,2021-10-23 23:30:00,54004.08,57794.61000000011
Buy,13,4180.18,2021-10-24 00:00:00,54342.340000000004,3452.270000000106
Sell,13,4163.82,2021-10-24 00:15:00,54129.659999999996,57581.9300000001
Buy,13,4163.82,2021-10-24 00:15:00,54129.659999999996,3452.270000000106
Sell,13,4150.01,2021-10-24 00:30:00,53950.130000000005,57402.40000000011
Buy,13,4136.47,2021-10-24 01:00:00,53774.11,3628.29000000011
Sell,13,4134.0,2021-10-24 01:15:00,53742.0,57370.29000000011
Buy,13,4134.0,2021-10-24 01:15:00,53742.0,3628.29000000011
Sell,13,4129.47,2021-10-24 01:30:00,53683.11,57311.40000000011
Buy,13,4132.14,2021-10-24 02:00:00,53717.82000000001,3593.5800000001036
Sell,13,4129.24,2021-10-24 02:15:00,53680.119999999995,57273.7000000001
Buy,13,4147.82,2021-10-24 03:00:00,53921.659999999996,3352.0400000001027
Sell,13,4138.48,2021-10-24 03:15:00,53800.23999999999,57152.28000000009
Buy,13,4142.66,2021-10-24 03:30:00,53854.58,3297.7000000000917
Sell,13,4137.87,2021-10-24 03:45:00,53792.31,57090.01000000009
Buy,13,4137.87,2021-10-24 03:45:00,53792.31,3297.7000000000917
Sell,13,4124.21,2021-10-24 04:00:00,53614.73,56912.430000000095
Buy,13,4124.21,2021-10-24 04:00:00,53614.73,3297.7000000000917
Sell,13,4115.85,2021-10-24 04:15:00,53506.05,56803.750000000095
Buy,13,4115.85,2021-10-24 04:15:00,53506.05,3297.7000000000917
Sell,13,4112.19,2021-10-24 04:30:00,53458.469999999994,56756.170000000086
Buy,13,4112.19,2021-10-24 04:30:00,53458.469999999994,3297.7000000000917
Sell,13,4111.03,2021-10-24 04:45:00,53443.39,56741.09000000009
Buy,13,4125.92,2021-10-24 05:15:00,53636.96,3104.130000000092
Sell,13,4118.84,2021-10-24 05:30:00,53544.92,56649.05000000009
Buy,13,4118.84,2021-10-24 05:30:00,53544.92,3104.130000000092
Sell,13,4114.34,2021-10-24 05:45:00,53486.42,56590.55000000009
Buy,13,4120.34,2021-10-24 06:00:00,53564.42,3026.130000000092
Sell,13,4111.89,2021-10-24 06:15:00,53454.57000000001,56480.7000000001
Buy,13,4111.89,2021-10-24 06:15:00,53454.57000000001,3026.130000000092
Sell,13,4100.01,2021-10-24 06:30:00,53300.130000000005,56326.2600000001
Buy,13,4100.01,2021-10-24 06:30:00,53300.130000000005,3026.130000000092
Sell,13,4093.99,2021-10-24 06:45:00,53221.869999999995,56248.00000000009
Buy,13,4107.77,2021-10-24 07:30:00,53401.01000000001,2846.990000000078
Sell,13,4098.84,2021-10-24 07:45:00,53284.92,56131.910000000076
Buy,13,4098.84,2021-10-24 07:45:00,53284.92,2846.990000000078
Sell,13,4086.01,2021-10-24 08:00:00,53118.130000000005,55965.12000000008
Buy,13,4091.63,2021-10-24 08:15:00,53191.19,2773.9300000000803
Sell,13,4090.22,2021-10-24 08:30:00,53172.86,55946.79000000008
Buy,13,4090.22,2021-10-24 08:30:00,53172.86,2773.9300000000803
Sell,13,4076.6,2021-10-24 08:45:00,52995.799999999996,55769.730000000076
Buy,13,4123.53,2021-10-24 09:15:00,53605.89,2163.8400000000765
Sell,13,4111.37,2021-10-24 09:30:00,53447.81,55611.650000000074
Buy,13,4111.37,2021-10-24 09:30:00,53447.81,2163.8400000000765
Sell,13,4095.89,2021-10-24 09:45:00,53246.57,55410.410000000076
Buy,13,4108.83,2021-10-24 10:15:00,53414.79,1995.6200000000754
Sell,13,4093.44,2021-10-24 10:30:00,53214.72,55210.34000000008
Buy,13,4093.44,2021-10-24 10:30:00,53214.72,1995.6200000000754
Sell,13,4093.95,2021-10-24 10:45:00,53221.35,55216.970000000074
Buy,13,4093.95,2021-10-24 10:45:00,53221.35,1995.6200000000754
Sell,13,4081.74,2021-10-24 11:00:00,53062.619999999995,55058.24000000007
Buy,13,4081.74,2021-10-24 11:00:00,53062.619999999995,1995.6200000000754
Sell,13,4067.38,2021-10-24 11:15:00,52875.94,54871.56000000008
Buy,13,4067.38,2021-10-24 11:15:00,52875.94,1995.6200000000754
Sell,13,4036.73,2021-10-24 11:30:00,52477.49,54473.11000000007
Buy,13,4036.73,2021-10-24 11:30:00,52477.49,1995.6200000000754
Sell,13,4030.62,2021-10-24 11:45:00,52398.06,54393.68000000007
Buy,13,4030.62,2021-10-24 11:45:00,52398.06,1995.6200000000754
Sell,13,4029.77,2021-10-24 12:00:00,52387.01,54382.63000000008
Buy,13,4029.77,2021-10-24 12:00:00,52387.01,1995.6200000000754
Sell,13,4032.99,2021-10-24 12:15:00,52428.869999999995,54424.49000000007
Buy,13,4066.18,2021-10-24 13:15:00,52860.34,1564.1500000000742
Sell,13,4055.13,2021-10-24 13:30:00,52716.69,54280.84000000008
Buy,13,4055.13,2021-10-24 13:30:00,52716.69,1564.1500000000742
Sell,13,4049.01,2021-10-24 13:45:00,52637.130000000005,54201.28000000008
Buy,13,4049.01,2021-10-24 13:45:00,52637.130000000005,1564.1500000000742
Sell,13,4047.99,2021-10-24 14:00:00,52623.869999999995,54188.02000000007
Buy,13,4047.99,2021-10-24 14:00:00,52623.869999999995,1564.1500000000742
Sell,13,4035.28,2021-10-24 14:15:00,52458.64,54022.79000000007
Buy,13,4035.28,2021-10-24 14:15:00,52458.64,1564.1500000000742
Sell,13,4025.63,2021-10-24 14:30:00,52333.19,53897.34000000008
Buy,13,4025.63,2021-10-24 14:30:00,52333.19,1564.1500000000742
Sell,13,4025.58,2021-10-24 14:45:00,52332.54,53896.690000000075
Buy,13,4025.58,2021-10-24 14:45:00,52332.54,1564.1500000000742
Sell,13,4024.69,2021-10-24 15:00:00,52320.97,53885.120000000075
Buy,13,4024.69,2021-10-24 15:00:00,52320.97,1564.1500000000742
Sell,13,3990.06,2021-10-24 15:15:00,51870.78,53434.93000000007
Buy,13,4018.77,2021-10-24 15:30:00,52244.01,1190.920000000071
Sell,13,4003.64,2021-10-24 15:45:00,52047.32,53238.24000000007
Buy,13,4003.64,2021-10-24 15:45:00,52047.32,1190.920000000071
Sell,13,3987.5,2021-10-24 16:00:00,51837.5,53028.42000000007
Buy,13,4028.69,2021-10-24 17:00:00,52372.97,655.4500000000698
Sell,13,4033.19,2021-10-24 17:15:00,52431.47,53086.92000000007
Buy,13,4033.19,2021-10-24 17:15:00,52431.47,655.4500000000698
Sell,13,4028.33,2021-10-24 17:30:00,52368.29,53023.74000000007
Buy,13,4028.33,2021-10-24 17:30:00,52368.29,655.4500000000698
Sell,13,4026.89,2021-10-24 17:45:00,52349.57,53005.02000000007
Buy,13,4026.89,2021-10-24 17:45:00,52349.57,655.4500000000698
Sell,13,3999.99,2021-10-24 18:00:00,51999.869999999995,52655.320000000065
Buy,13,3999.99,2021-10-24 18:00:00,51999.869999999995,655.4500000000698
Sell,13,3980.18,2021-10-24 18:15:00,51742.34,52397.790000000066
Buy,13,3980.18,2021-10-24 18:15:00,51742.34,655.4500000000698
Sell,13,3982.7,2021-10-24 18:30:00,51775.1,52430.55000000007
Buy,13,3982.7,2021-10-24 18:30:00,51775.1,655.4500000000698
Sell,13,3997.99,2021-10-24 18:45:00,51973.869999999995,52629.320000000065
Buy,13,4023.41,2021-10-24 19:00:00,52304.33,324.99000000006345
Sell,13,4014.52,2021-10-24 19:15:00,52188.76,52513.750000000065
Buy,12,4045.0,2021-10-24 19:45:00,48540.0,3973.7500000000655
Sell,12,4051.01,2021-10-24 20:00:00,48612.12,52585.87000000007
Buy,12,4051.01,2021-10-24 20:00:00,48612.12,3973.7500000000655
Sell,12,4056.5,2021-10-24 20:15:00,48678.0,52651.750000000065
Buy,12,4056.5,2021-10-24 20:15:00,48678.0,3973.7500000000655
Sell,12,4048.32,2021-10-24 20:30:00,48579.840000000004,52553.59000000007
Buy,12,4069.03,2021-10-24 20:45:00,48828.36,3725.2300000000687
Sell,12,4080.59,2021-10-24 21:00:00,48967.08,52692.31000000007
Buy,12,4094.51,2021-10-24 21:15:00,49134.12,3558.190000000068
Sell,12,4085.99,2021-10-24 21:30:00,49031.88,52590.070000000065
Buy,12,4085.99,2021-10-24 21:30:00,49031.88,3558.190000000068
Sell,12,4082.56,2021-10-24 21:45:00,48990.72,52548.91000000007
Buy,12,4086.53,2021-10-24 22:00:00,49038.36,3510.5500000000684
Sell,12,4076.37,2021-10-24 22:15:00,48916.44,52426.99000000007
Buy,12,4076.37,2021-10-24 22:15:00,48916.44,3510.5500000000684
Sell,12,4074.38,2021-10-24 22:30:00,48892.56,52403.110000000066
Buy,12,4074.38,2021-10-24 22:30:00,48892.56,3510.5500000000684
Sell,12,4076.57,2021-10-24 22:45:00,48918.840000000004,52429.39000000007
Buy,12,4076.57,2021-10-24 22:45:00,48918.840000000004,3510.5500000000684
Sell,12,4076.12,2021-10-24 23:00:00,48913.44,52423.99000000007
Buy,12,4081.22,2021-10-24 23:15:00,48974.64,3449.3500000000713
Sell,12,4071.91,2021-10-24 23:30:00,48862.92,52312.27000000007
Buy,12,4094.99,2021-10-25 00:00:00,49139.88,3172.390000000072
Sell,12,4097.06,2021-10-25 00:15:00,49164.72,52337.11000000007
Buy,12,4117.71,2021-10-25 00:30:00,49412.520000000004,2924.5900000000693
Sell,12,4135.86,2021-10-25 00:45:00,49630.31999999999,52554.91000000006
Buy,12,4135.86,2021-10-25 00:45:00,49630.31999999999,2924.5900000000693
Sell,12,4142.33,2021-10-25 01:00:00,49707.96,52632.55000000007
Buy,12,4142.33,2021-10-25 01:00:00,49707.96,2924.5900000000693
Sell,12,4126.66,2021-10-25 01:15:00,49519.92,52444.51000000007
Buy,12,4126.66,2021-10-25 01:15:00,49519.92,2924.5900000000693
Sell,12,4127.78,2021-10-25 01:30:00,49533.36,52457.95000000007
Buy,12,4127.78,2021-10-25 01:30:00,49533.36,2924.5900000000693
Sell,12,4122.62,2021-10-25 01:45:00,49471.44,52396.03000000007
Buy,12,4122.62,2021-10-25 01:45:00,49471.44,2924.5900000000693
Sell,12,4113.19,2021-10-25 02:00:00,49358.28,52282.87000000007
Buy,12,4138.32,2021-10-25 03:00:00,49659.84,2623.0300000000716
Sell,12,4135.0,2021-10-25 03:15:00,49620.0,52243.03000000007
Buy,12,4141.06,2021-10-25 03:30:00,49692.72,2550.3100000000704
Sell,12,4138.89,2021-10-25 03:45:00,49666.68000000001,52216.99000000008
Buy,12,4153.74,2021-10-25 04:00:00,49844.88,2372.1100000000806
Sell,12,4141.27,2021-10-25 04:15:00,49695.240000000005,52067.350000000086
Buy,12,4141.27,2021-10-25 04:15:00,49695.240000000005,2372.1100000000806
Sell,12,4145.46,2021-10-25 04:30:00,49745.520000000004,52117.630000000085
Buy,12,4152.69,2021-10-25 04:45:00,49832.28,2285.350000000086
Sell,12,4139.71,2021-10-25 05:00:00,49676.520000000004,51961.87000000009
Buy,12,4139.71,2021-10-25 05:00:00,49676.520000000004,2285.350000000086
Sell,12,4141.09,2021-10-25 05:15:00,49693.08,51978.43000000009
Buy,12,4141.09,2021-10-25 05:15:00,49693.08,2285.350000000086
Sell,12,4131.78,2021-10-25 05:30:00,49581.36,51866.71000000009
Buy,12,4131.78,2021-10-25 05:30:00,49581.36,2285.350000000086
Sell,12,4128.01,2021-10-25 05:45:00,49536.12,51821.47000000009
Buy,12,4124.99,2021-10-25 06:00:00,49499.88,2321.590000000091
Sell,12,4125.3,2021-10-25 06:15:00,49503.600000000006,51825.1900000001
Buy,12,4127.59,2021-10-25 06:45:00,49531.08,2294.110000000095
Sell,12,3805.72,2021-10-25 07:00:00,45668.64,47962.750000000095
Buy,11,4163.49,2021-10-25 07:15:00,45798.39,2164.360000000095
Sell,11,4167.76,2021-10-25 07:30:00,45845.36,48009.720000000096
Buy,11,4167.76,2021-10-25 07:30:00,45845.36,2164.360000000095
Sell,11,4153.57,2021-10-25 07:45:00,45689.27,47853.63000000009
Buy,11,4164.25,2021-10-25 08:00:00,45806.75,2046.880000000092
Sell,11,4159.03,2021-10-25 08:15:00,45749.329999999994,47796.21000000009
Buy,11,4159.03,2021-10-25 08:15:00,45749.329999999994,2046.880000000092
Sell,11,4136.27,2021-10-25 08:30:00,45498.97,47545.85000000009
Buy,11,4136.27,2021-10-25 08:30:00,45498.97,2046.880000000092
Sell,11,4128.09,2021-10-25 08:45:00,45408.990000000005,47455.8700000001
Buy,11,4140.24,2021-10-25 10:00:00,45542.64,1913.2300000000978
Sell,11,4126.13,2021-10-25 10:15:00,45387.43,47300.6600000001
Buy,11,4126.13,2021-10-25 10:15:00,45387.43,1913.2300000000978
Sell,11,4117.08,2021-10-25 10:30:00,45287.88,47201.110000000095
Buy,11,4117.08,2021-10-25 10:30:00,45287.88,1913.2300000000978
Sell,11,3805.72,2021-10-25 10:45:00,41862.92,43776.150000000096
Buy,10,4128.91,2021-10-25 11:00:00,41289.1,2487.0500000000975
Sell,10,4151.2,2021-10-25 11:15:00,41512.0,43999.0500000001
Buy,10,4138.93,2021-10-25 12:00:00,41389.3,2609.7500000000946
Sell,10,4133.52,2021-10-25 12:15:00,41335.200000000004,43944.9500000001
Buy,10,4133.52,2021-10-25 12:15:00,41335.200000000004,2609.7500000000946
Sell,10,4129.26,2021-10-25 12:30:00,41292.600000000006,43902.3500000001
Buy,10,4162.82,2021-10-25 13:45:00,41628.2,2274.1500000001033
Sell,10,4152.79,2021-10-25 14:00:00,41527.9,43802.050000000105
Buy,10,4152.79,2021-10-25 14:00:00,41527.9,2274.1500000001033
Sell,10,4144.92,2021-10-25 14:15:00,41449.2,43723.3500000001
Buy,10,4144.92,2021-10-25 14:15:00,41449.2,2274.1500000001033
Sell,10,3805.72,2021-10-25 14:30:00,38057.2,40331.3500000001
Buy,9,4156.13,2021-10-25 14:45:00,37405.17,2926.180000000102
Sell,9,4139.01,2021-10-25 15:00:00,37251.090000000004,40177.270000000106
Buy,9,4139.01,2021-10-25 15:00:00,37251.090000000004,2926.180000000102
Sell,9,4151.63,2021-10-25 15:15:00,37364.67,40290.8500000001
Buy,9,4216.39,2021-10-25 15:45:00,37947.51,2343.3400000000984
Sell,9,4203.7,2021-10-25 16:00:00,37833.299999999996,40176.640000000094
Buy,9,4213.83,2021-10-25 16:15:00,37924.47,2252.170000000093
Sell,9,4222.22,2021-10-25 16:30:00,37999.98,40252.150000000096
Buy,9,4222.22,2021-10-25 16:30:00,37999.98,2252.170000000093
Sell,9,4234.27,2021-10-25 16:45:00,38108.43000000001,40360.6000000001
Buy,9,4234.27,2021-10-25 16:45:00,38108.43000000001,2252.170000000093
Sell,9,4210.56,2021-10-25 17:00:00,37895.04,40147.210000000094
Buy,9,4210.56,2021-10-25 17:00:00,37895.04,2252.170000000093
Sell,9,4200.31,2021-10-25 17:15:00,37802.79,40054.960000000094
Buy,9,4189.45,2021-10-25 17:30:00,37705.049999999996,2349.910000000098
Sell,9,4189.91,2021-10-25 17:45:00,37709.19,40059.1000000001
Buy,9,4189.91,2021-10-25 17:45:00,37709.19,2349.910000000098
Sell,9,4188.99,2021-10-25 18:00:00,37700.909999999996,40050.820000000094
Buy,9,4205.61,2021-10-25 18:15:00,37850.49,2200.3300000000963
Sell,9,4200.88,2021-10-25 18:30:00,37807.92,40008.250000000095
Buy,9,4214.53,2021-10-25 18:45:00,37930.77,2077.480000000098
Sell,9,4203.35,2021-10-25 19:00:00,37830.15,39907.6300000001
Buy,9,4203.35,2021-10-25 19:00:00,37830.15,2077.480000000098
Sell,9,4196.84,2021-10-25 19:15:00,37771.56,39849.040000000095
Buy,9,4196.84,2021-10-25 19:15:00,37771.56,2077.480000000098
Sell,9,4189.49,2021-10-25 19:30:00,37705.409999999996,39782.890000000094
Buy,9,4189.49,2021-10-25 19:30:00,37705.409999999996,2077.480000000098
Sell,9,4189.11,2021-10-25 19:45:00,37701.99,39779.470000000096
Buy,9,4202.4,2021-10-25 20:00:00,37821.6,1957.8700000000972
Sell,9,4194.88,2021-10-25 20:15:00,37753.92,39711.790000000095
Buy,9,4194.88,2021-10-25 20:15:00,37753.92,1957.8700000000972
Sell,9,4191.54,2021-10-25 20:30:00,37723.86,39681.7300000001
Buy,9,4191.54,2021-10-25 20:30:00,37723.86,1957.8700000000972
Sell,9,4184.74,2021-10-25 20:45:00,37662.659999999996,39620.53000000009
Buy,9,4199.16,2021-10-25 21:00:00,37792.44,1828.090000000091
Sell,9,4193.88,2021-10-25 21:15:00,37744.92,39573.01000000009
Buy,9,4203.25,2021-10-25 21:30:00,37829.25,1743.7600000000893
Sell,9,4194.66,2021-10-25 21:45:00,37751.94,39495.70000000009
Buy,9,4194.66,2021-10-25 21:45:00,37751.94,1743.7600000000893
Sell,9,4201.62,2021-10-25 22:00:00,37814.58,39558.34000000009
Buy,9,4224.0,2021-10-25 22:45:00,38016.0,1542.340000000091
Sell,9,4224.25,2021-10-25 23:00:00,38018.25,39560.59000000009
Buy,9,4224.25,2021-10-25 23:00:00,38018.25,1542.340000000091
Sell,9,4214.53,2021-10-25 23:15:00,37930.77,39473.11000000009
Buy,9,4214.53,2021-10-25 23:15:00,37930.77,1542.340000000091
Sell,9,4216.81,2021-10-25 23:30:00,37951.29,39493.63000000009
Buy,9,4224.14,2021-10-25 23:45:00,38017.26,1476.37000000009
Sell,9,4218.38,2021-10-26 00:00:00,37965.42,39441.79000000009
Buy,9,4263.57,2021-10-26 00:15:00,38372.13,1069.6600000000908
Sell,9,4241.34,2021-10-26 00:30:00,38172.06,39241.72000000009
Buy,9,4241.34,2021-10-26 00:30:00,38172.06,1069.6600000000908
Sell,9,4245.55,2021-10-26 00:45:00,38209.950000000004,39279.610000000095
Buy,9,4245.55,2021-10-26 00:45:00,38209.950000000004,1069.6600000000908
Sell,9,4229.32,2021-10-26 01:00:00,38063.88,39133.54000000009
Buy,9,4229.32,2021-10-26 01:00:00,38063.88,1069.6600000000908
Sell,9,4229.23,2021-10-26 01:15:00,38063.06999999999,39132.73000000008
Buy,9,4225.39,2021-10-26 01:30:00,38028.51,1104.2200000000812
Sell,9,4223.05,2021-10-26 01:45:00,38007.450000000004,39111.670000000086
Buy,9,4246.54,2021-10-26 02:15:00,38218.86,892.810000000085
Sell,9,4240.72,2021-10-26 02:30:00,38166.48,39059.29000000009
Buy,9,4240.72,2021-10-26 02:30:00,38166.48,892.810000000085
Sell,9,4237.98,2021-10-26 02:45:00,38141.81999999999,39034.63000000008
Buy,9,4244.8,2021-10-26 03:00:00,38203.200000000004,831.430000000073
Sell,9,4233.11,2021-10-26 03:15:00,38097.99,38929.42000000007
Buy,9,4233.11,2021-10-26 03:15:00,38097.99,831.430000000073
Sell,9,4229.78,2021-10-26 03:30:00,38068.02,38899.45000000007
Buy,9,4228.41,2021-10-26 03:45:00,38055.69,843.7600000000675
Sell,9,4223.32,2021-10-26 04:00:00,38009.88,38853.640000000065
Buy,9,4223.32,2021-10-26 04:00:00,38009.88,843.7600000000675
Sell,9,4211.97,2021-10-26 04:15:00,37907.73,38751.49000000007
Buy,9,4209.1,2021-10-26 04:30:00,37881.9,869.5900000000693
Sell,9,4210.37,2021-10-26 04:45:00,37893.33,38762.92000000007
Buy,9,4214.07,2021-10-26 05:00:00,37926.63,836.2900000000736
Sell,9,4213.63,2021-10-26 05:15:00,37922.67,38758.96000000007
Buy,9,4213.63,2021-10-26 05:15:00,37922.67,836.2900000000736
Sell,9,4208.37,2021-10-26 05:30:00,37875.33,38711.620000000075
Buy,9,4208.37,2021-10-26 05:30:00,37875.33,836.2900000000736
Sell,9,4203.73,2021-10-26 05:45:00,37833.56999999999,38669.860000000066
Buy,9,4203.73,2021-10-26 05:45:00,37833.56999999999,836.2900000000736
Sell,9,4196.54,2021-10-26 06:00:00,37768.86,38605.150000000074
Buy,9,4205.71,2021-10-26 06:30:00,37851.39,753.7600000000748
Sell,9,4194.15,2021-10-26 06:45:00,37747.35,38501.11000000007
Buy,9,4194.15,2021-10-26 06:45:00,37747.35,753.7600000000748
Sell,9,4187.14,2021-10-26 07:00:00,37684.26,38438.02000000008
Buy,9,4187.14,2021-10-26 07:00:00,37684.26,753.7600000000748
Sell,9,4188.79,2021-10-26 07:15:00,37699.11,38452.870000000075
Buy,9,4226.04,2021-10-26 08:00:00,38034.36,418.5100000000748
Sell,9,4228.49,2021-10-26 08:15:00,38056.409999999996,38474.92000000007
Buy,9,4228.49,2021-10-26 08:15:00,38056.409999999996,418.5100000000748
Sell,9,4219.69,2021-10-26 08:30:00,37977.21,38395.720000000074
Buy,9,4219.69,2021-10-26 08:30:00,37977.21,418.5100000000748
Sell,9,4218.07,2021-10-26 08:45:00,37962.63,38381.14000000007
Buy,9,4218.07,2021-10-26 08:45:00,37962.63,418.5100000000748
Sell,9,4209.48,2021-10-26 09:00:00,37885.31999999999,38303.83000000007
Buy,9,4219.96,2021-10-26 09:15:00,37979.64,324.1900000000678
Sell,9,4212.58,2021-10-26 09:30:00,37913.22,38237.41000000007
Buy,9,4212.58,2021-10-26 09:30:00,37913.22,324.1900000000678
Sell,9,4212.48,2021-10-26 09:45:00,37912.31999999999,38236.51000000006
Buy,9,4212.48,2021-10-26 09:45:00,37912.31999999999,324.1900000000678
Sell,9,4201.02,2021-10-26 10:00:00,37809.18000000001,38133.370000000075
Buy,9,4231.41,2021-10-26 10:45:00,38082.69,50.68000000007305
Sell,9,4222.52,2021-10-26 11:00:00,38002.68000000001,38053.36000000008
Buy,9,4222.52,2021-10-26 11:00:00,38002.68000000001,50.68000000007305
Sell,9,4214.0,2021-10-26 11:15:00,37926.0,37976.68000000007
Buy,9,4214.0,2021-10-26 11:15:00,37926.0,50.68000000007305
Sell,9,4211.59,2021-10-26 11:30:00,37904.31,37954.99000000007
Buy,8,4220.04,2021-10-26 11:45:00,33760.32,4194.670000000071
Sell,8,4212.8,2021-10-26 12:00:00,33702.4,37897.07000000007
Buy,8,4212.8,2021-10-26 12:00:00,33702.4,4194.670000000071
Sell,8,4199.17,2021-10-26 12:15:00,33593.36,37788.03000000007
Buy,8,4199.17,2021-10-26 12:15:00,33593.36,4194.670000000071
Sell,8,4192.47,2021-10-26 12:30:00,33539.76,37734.43000000007
Buy,8,4195.23,2021-10-26 12:45:00,33561.84,4172.5900000000765
Sell,8,4195.59,2021-10-26 13:00:00,33564.72,37737.31000000008
Buy,8,4202.08,2021-10-26 13:15:00,33616.64,4120.670000000078
Sell,8,4202.05,2021-10-26 13:30:00,33616.4,37737.07000000008
Buy,8,4202.05,2021-10-26 13:30:00,33616.4,4120.670000000078
Sell,8,4190.38,2021-10-26 13:45:00,33523.04,37643.71000000008
Buy,8,4190.38,2021-10-26 13:45:00,33523.04,4120.670000000078
Sell,8,4159.13,2021-10-26 14:00:00,33273.04,37393.71000000008
Buy,8,4159.13,2021-10-26 14:00:00,33273.04,4120.670000000078
Sell,8,4155.38,2021-10-26 14:15:00,33243.04,37363.71000000008
Buy,8,4155.38,2021-10-26 14:15:00,33243.04,4120.670000000078
Sell,8,4154.96,2021-10-26 14:30:00,33239.68,37360.35000000008
Buy,8,4154.96,2021-10-26 14:30:00,33239.68,4120.670000000078
Sell,8,4155.38,2021-10-26 14:45:00,33243.04,37363.71000000008
Buy,8,4189.47,2021-10-26 15:45:00,33515.76,3847.950000000077
Sell,8,4180.89,2021-10-26 16:00:00,33447.12,37295.07000000008
Buy,8,4180.89,2021-10-26 16:00:00,33447.12,3847.950000000077
Sell,8,4180.32,2021-10-26 16:15:00,33442.56,37290.510000000075
Buy,8,4180.32,2021-10-26 16:15:00,33442.56,3847.950000000077
Sell,8,4173.09,2021-10-26 16:30:00,33384.72,37232.67000000008
Buy,8,4173.09,2021-10-26 16:30:00,33384.72,3847.950000000077
Sell,8,4170.89,2021-10-26 16:45:00,33367.12,37215.07000000008
Buy,8,4207.62,2021-10-26 17:30:00,33660.96,3554.1100000000806
Sell,8,4220.33,2021-10-26 17:45:00,33762.64,37316.75000000008
Buy,8,4220.33,2021-10-26 17:45:00,33762.64,3554.1100000000806
Sell,8,4230.11,2021-10-26 18:00:00,33840.88,37394.99000000008
Buy,8,4230.11,2021-10-26 18:00:00,33840.88,3554.1100000000806
Sell,8,4221.14,2021-10-26 18:15:00,33769.12,37323.23000000008
Buy,8,4221.14,2021-10-26 18:15:00,33769.12,3554.1100000000806
Sell,8,4211.42,2021-10-26 18:30:00,33691.36,37245.47000000008
Buy,8,4211.42,2021-10-26 18:30:00,33691.36,3554.1100000000806
Sell,8,4213.85,2021-10-26 18:45:00,33710.8,37264.91000000008
Buy,8,4223.08,2021-10-26 19:00:00,33784.64,3480.270000000084
Sell,8,4219.39,2021-10-26 19:15:00,33755.12,37235.39000000009
Buy,8,4219.39,2021-10-26 19:15:00,33755.12,3480.270000000084
Sell,8,4223.51,2021-10-26 19:30:00,33788.08,37268.350000000086
Buy,8,4223.51,2021-10-26 19:30:00,33788.08,3480.270000000084
Sell,8,4214.87,2021-10-26 19:45:00,33718.96,37199.23000000008
Buy,8,4296.04,2021-10-26 20:15:00,34368.32,2830.9100000000835
Sell,8,4259.68,2021-10-26 20:30:00,34077.44,36908.350000000086
Buy,8,4259.68,2021-10-26 20:30:00,34077.44,2830.9100000000835
Sell,8,4270.15,2021-10-26 20:45:00,34161.2,36992.11000000008
Buy,8,4274.86,2021-10-26 21:00:00,34198.88,2793.2300000000832
Sell,8,4265.63,2021-10-26 21:15:00,34125.04,36918.270000000084
Buy,8,4265.63,2021-10-26 21:15:00,34125.04,2793.2300000000832
Sell,8,4249.91,2021-10-26 21:30:00,33999.28,36792.51000000008
Buy,8,4249.91,2021-10-26 21:30:00,33999.28,2793.2300000000832
Sell,8,4207.17,2021-10-26 21:45:00,33657.36,36450.590000000084
Buy,8,4207.17,2021-10-26 21:45:00,33657.36,2793.2300000000832
Sell,8,4196.23,2021-10-26 22:00:00,33569.84,36363.07000000008
Buy,8,4196.23,2021-10-26 22:00:00,33569.84,2793.2300000000832
Sell,8,4187.25,2021-10-26 22:15:00,33498.0,36291.23000000008
Buy,8,4187.25,2021-10-26 22:15:00,33498.0,2793.2300000000832
Sell,8,4137.65,2021-10-26 22:30:00,33101.2,35894.43000000008
Buy,8,4140.31,2021-10-26 23:00:00,33122.48,2771.950000000077
Sell,8,4128.83,2021-10-26 23:15:00,33030.64,35802.59000000008
Buy,8,4164.76,2021-10-27 00:15:00,33318.08,2484.510000000075
Sell,8,4148.71,2021-10-27 00:30:00,33189.68,35674.190000000075
Buy,8,4177.92,2021-10-27 01:15:00,33423.36,2250.8300000000745
Sell,8,4167.08,2021-10-27 01:30:00,33336.64,35587.470000000074
Buy,8,4167.08,2021-10-27 01:30:00,33336.64,2250.8300000000745
Sell,8,4151.13,2021-10-27 01:45:00,33209.04,35459.870000000075
Buy,8,4174.16,2021-10-27 02:15:00,33393.28,2066.5900000000765
Sell,8,4175.22,2021-10-27 02:30:00,33401.76,35468.35000000008
Buy,8,4175.22,2021-10-27 02:30:00,33401.76,2066.5900000000765
Sell,8,4184.31,2021-10-27 02:45:00,33474.48,35541.07000000008
Buy,8,4230.54,2021-10-27 03:15:00,33844.32,1696.75000000008
Sell,8,4212.31,2021-10-27 03:30:00,33698.48,35395.23000000008
Buy,8,4212.31,2021-10-27 03:30:00,33698.48,1696.75000000008
Sell,8,4214.29,2021-10-27 03:45:00,33714.32,35411.07000000008
Buy,8,4281.83,2021-10-27 04:15:00,34254.64,1156.4300000000803
Sell,8,4289.34,2021-10-27 04:30:00,34314.72,35471.15000000008
Buy,8,4289.34,2021-10-27 04:30:00,34314.72,1156.4300000000803
Sell,8,4287.14,2021-10-27 04:45:00,34297.12,35453.55000000008
Buy,8,4296.07,2021-10-27 05:00:00,34368.56,1084.9900000000853
Sell,8,4283.56,2021-10-27 05:15:00,34268.48,35353.47000000009
Buy,8,4283.56,2021-10-27 05:15:00,34268.48,1084.9900000000853
Sell,8,4277.38,2021-10-27 05:30:00,34219.04,35304.030000000086
Buy,8,4277.38,2021-10-27 05:30:00,34219.04,1084.9900000000853
Sell,8,4277.67,2021-10-27 05:45:00,34221.36,35306.350000000086
Buy,8,4277.67,2021-10-27 05:45:00,34221.36,1084.9900000000853
Sell,8,4265.04,2021-10-27 06:00:00,34120.32,35205.310000000085
Buy,8,4265.04,2021-10-27 06:00:00,34120.32,1084.9900000000853
Sell,8,4259.48,2021-10-27 06:15:00,34075.84,35160.83000000008
Buy,8,4259.48,2021-10-27 06:15:00,34075.84,1084.9900000000853
Sell,8,4243.01,2021-10-27 06:30:00,33944.08,35029.07000000009
Buy,8,4243.01,2021-10-27 06:30:00,33944.08,1084.9900000000853
Sell,8,4245.01,2021-10-27 06:45:00,33960.08,35045.07000000009
Buy,8,4245.01,2021-10-27 06:45:00,33960.08,1084.9900000000853
Sell,8,4232.91,2021-10-27 07:00:00,33863.28,34948.270000000084
Buy,8,4232.91,2021-10-27 07:00:00,33863.28,1084.9900000000853
Sell,8,4209.23,2021-10-27 07:15:00,33673.84,34758.83000000008
Buy,8,4164.41,2021-10-27 07:30:00,33315.28,1443.550000000083
Sell,8,4139.76,2021-10-27 07:45:00,33118.08,34561.630000000085
Buy,8,4139.76,2021-10-27 07:45:00,33118.08,1443.550000000083
Sell,8,4039.02,2021-10-27 08:00:00,32312.16,33755.71000000008
Buy,8,4047.24,2021-10-27 08:15:00,32377.92,1377.790000000081
Sell,8,4035.5,2021-10-27 08:30:00,32284.0,33661.79000000008
Buy,8,4035.5,2021-10-27 08:30:00,32284.0,1377.790000000081
Sell,8,4049.66,2021-10-27 08:45:00,32397.28,33775.07000000008
Buy,8,4049.66,2021-10-27 08:45:00,32397.28,1377.790000000081
Sell,8,4015.93,2021-10-27 09:00:00,32127.44,33505.23000000008
Buy,8,4015.93,2021-10-27 09:00:00,32127.44,1377.7900000000845
Sell,8,3996.14,2021-10-27 09:15:00,31969.12,33346.91000000008
Buy,8,3996.14,2021-10-27 09:15:00,31969.12,1377.7900000000845
Sell,8,4021.72,2021-10-27 09:30:00,32173.76,33551.55000000008
Buy,8,4021.72,2021-10-27 09:30:00,32173.76,1377.7900000000845
Sell,8,4020.0,2021-10-27 09:45:00,32160.0,33537.79000000008
Buy,8,4020.0,2021-10-27 09:45:00,32160.0,1377.790000000081
Sell,8,4009.99,2021-10-27 10:00:00,32079.92,33457.71000000008
Buy,8,4009.99,2021-10-27 10:00:00,32079.92,1377.790000000081
Sell,8,3978.82,2021-10-27 10:15:00,31830.56,33208.35000000008
Buy,8,4018.64,2021-10-27 10:30:00,32149.12,1059.2300000000796
Sell,8,4024.54,2021-10-27 10:45:00,32196.32,33255.550000000076
Buy,8,4046.93,2021-10-27 11:00:00,32375.44,880.110000000077
Sell,8,4021.26,2021-10-27 11:15:00,32170.08,33050.190000000075
Buy,8,4021.26,2021-10-27 11:15:00,32170.08,880.1100000000733
Sell,8,4006.12,2021-10-27 11:30:00,32048.96,32929.07000000007
Buy,8,3995.01,2021-10-27 11:45:00,31960.08,968.9900000000707
Sell,8,3995.07,2021-10-27 12:00:00,31960.56,32929.550000000076
Buy,8,4018.7,2021-10-27 12:15:00,32149.6,779.9500000000771
Sell,8,4005.25,2021-10-27 12:30:00,32042.0,32821.95000000008
Buy,8,4005.25,2021-10-27 12:30:00,32042.0,779.9500000000771
Sell,8,4014.36,2021-10-27 12:45:00,32114.88,32894.830000000075
Buy,8,4027.2,2021-10-27 13:00:00,32217.6,677.230000000076
Sell,8,3998.69,2021-10-27 13:15:00,31989.52,32666.750000000076
Buy,8,4024.45,2021-10-27 13:30:00,32195.6,471.15000000007785
Sell,8,3997.39,2021-10-27 13:45:00,31979.12,32450.270000000077
Buy,8,3997.39,2021-10-27 13:45:00,31979.12,471.15000000007785
Sell,8,3986.79,2021-10-27 14:00:00,31894.32,32365.470000000078
Buy,8,4037.55,2021-10-27 15:00:00,32300.4,65.0700000000761
Sell,8,3998.88,2021-10-27 15:15:00,31991.04,32056.110000000077
Buy,8,3998.88,2021-10-27 15:15:00,31991.04,65.0700000000761
Sell,8,3989.54,2021-10-27 15:30:00,31916.32,31981.390000000076
Buy,8,3995.51,2021-10-27 15:45:00,31964.08,17.31000000007407
Sell,8,3980.13,2021-10-27 16:00:00,31841.04,31858.350000000075
Buy,8,3980.13,2021-10-27 16:00:00,31841.04,17.31000000007407
Sell,8,3955.51,2021-10-27 16:15:00,31644.08,31661.390000000076
Buy,7,3991.78,2021-10-27 16:30:00,27942.460000000003,3718.930000000073
Sell,7,3980.83,2021-10-27 16:45:00,27865.809999999998,31584.74000000007
Buy,7,3997.13,2021-10-27 17:15:00,27979.91,3604.830000000071
Sell,7,3987.37,2021-10-27 17:30:00,27911.59,31516.42000000007
Buy,7,3988.33,2021-10-27 17:45:00,27918.309999999998,3598.1100000000733
Sell,7,3987.92,2021-10-27 18:00:00,27915.440000000002,31513.550000000076
Buy,7,3999.11,2021-10-27 18:15:00,27993.77,3519.7800000000752
Sell,7,3986.86,2021-10-27 18:30:00,27908.02,31427.800000000076
Buy,7,3986.86,2021-10-27 18:30:00,27908.02,3519.7800000000752
Sell,7,3971.38,2021-10-27 18:45:00,27799.66,31319.440000000075
Buy,7,3971.38,2021-10-27 18:45:00,27799.66,3519.7800000000752
Sell,7,3952.46,2021-10-27 19:00:00,27667.22,31187.000000000076
Buy,7,3952.46,2021-10-27 19:00:00,27667.22,3519.7800000000752
Sell,7,3963.94,2021-10-27 19:15:00,27747.58,31267.360000000077
Buy,7,3963.94,2021-10-27 19:15:00,27747.58,3519.7800000000752
Sell,7,3959.75,2021-10-27 19:30:00,27718.25,31238.030000000075
Buy,7,4002.03,2021-10-27 19:45:00,28014.210000000003,3223.8200000000725
Sell,7,3982.36,2021-10-27 20:00:00,27876.52,31100.340000000073
Buy,7,3982.36,2021-10-27 20:00:00,27876.52,3223.8200000000725
Sell,7,3978.32,2021-10-27 20:15:00,27848.24,31072.060000000074
Buy,7,3978.32,2021-10-27 20:15:00,27848.24,3223.8200000000725
Sell,7,3965.46,2021-10-27 20:30:00,27758.22,30982.040000000074
Buy,7,3994.12,2021-10-27 21:00:00,27958.84,3023.2000000000735
Sell,7,3988.01,2021-10-27 21:15:00,27916.07,30939.270000000073
Buy,7,4005.09,2021-10-27 21:30:00,28035.63,2903.640000000072
Sell,7,3994.8,2021-10-27 21:45:00,27963.600000000002,30867.240000000074
Buy,7,3994.8,2021-10-27 21:45:00,27963.600000000002,2903.640000000072
Sell,7,3977.72,2021-10-27 22:00:00,27844.039999999997,30747.68000000007
Buy,7,3986.88,2021-10-27 22:15:00,27908.16,2839.5200000000696
Sell,7,3971.54,2021-10-27 22:30:00,27800.78,30640.30000000007
Buy,7,3971.54,2021-10-27 22:30:00,27800.78,2839.5200000000696
Sell,7,3977.19,2021-10-27 22:45:00,27840.33,30679.85000000007
Buy,7,3977.19,2021-10-27 22:45:00,27840.33,2839.5200000000696
Sell,7,3975.28,2021-10-27 23:00:00,27826.960000000003,30666.480000000072
Buy,7,3975.28,2021-10-27 23:00:00,27826.960000000003,2839.5200000000696
Sell,7,3954.55,2021-10-27 23:15:00,27681.850000000002,30521.37000000007
Buy,7,3954.55,2021-10-27 23:15:00,27681.850000000002,2839.5200000000696
Sell,7,3946.8,2021-10-27 23:30:00,27627.600000000002,30467.12000000007
Buy,7,3946.8,2021-10-27 23:30:00,27627.600000000002,2839.5200000000696
Sell,7,3923.57,2021-10-27 23:45:00,27464.99,30304.51000000007
Buy,7,3946.54,2021-10-28 00:15:00,27625.78,2678.7300000000723
Sell,7,3940.49,2021-10-28 00:30:00,27583.43,30262.160000000073
Buy,7,3940.49,2021-10-28 00:30:00,27583.43,2678.7300000000723
Sell,7,3913.7,2021-10-28 00:45:00,27395.899999999998,30074.63000000007
Buy,7,3996.96,2021-10-28 01:45:00,27978.72,2095.910000000069
Sell,7,3980.65,2021-10-28 02:00:00,27864.55,29960.46000000007
Buy,7,3980.65,2021-10-28 02:00:00,27864.55,2095.910000000069
Sell,7,3975.81,2021-10-28 02:15:00,27830.67,29926.580000000067
Buy,7,4000.18,2021-10-28 02:45:00,28001.26,1925.3200000000688
Sell,7,4008.02,2021-10-28 03:00:00,28056.14,29981.46000000007
Buy,7,4008.02,2021-10-28 03:00:00,28056.14,1925.3200000000688
Sell,7,3986.64,2021-10-28 03:15:00,27906.48,29831.80000000007
Buy,7,3986.64,2021-10-28 03:15:00,27906.48,1925.3200000000688
Sell,7,3988.31,2021-10-28 03:30:00,27918.17,29843.490000000067
Buy,7,4018.0,2021-10-28 04:00:00,28126.0,1717.490000000067
Sell,7,3998.63,2021-10-28 04:15:00,27990.41,29707.900000000067
Buy,7,3998.63,2021-10-28 04:15:00,27990.41,1717.490000000067
Sell,7,4007.36,2021-10-28 04:30:00,28051.52,29769.010000000068
Buy,7,4011.0,2021-10-28 05:15:00,28077.0,1692.0100000000675
Sell,7,4016.98,2021-10-28 05:30:00,28118.86,29810.870000000068
Buy,7,4022.77,2021-10-28 05:45:00,28159.39,1651.4800000000687
Sell,7,4005.91,2021-10-28 06:00:00,28041.37,29692.850000000068
Buy,7,4017.77,2021-10-28 06:30:00,28124.39,1568.4600000000682
Sell,7,4023.46,2021-10-28 06:45:00,28164.22,29732.68000000007
Buy,7,4023.46,2021-10-28 06:45:00,28164.22,1568.4600000000682
Sell,7,4016.35,2021-10-28 07:00:00,28114.45,29682.91000000007
Buy,7,4024.35,2021-10-28 07:15:00,28170.45,1512.4600000000682
Sell,7,4014.97,2021-10-28 07:30:00,28104.789999999997,29617.250000000065
Buy,7,4014.97,2021-10-28 07:30:00,28104.789999999997,1512.4600000000682
Sell,7,4012.56,2021-10-28 07:45:00,28087.92,29600.380000000067
Buy,7,4050.45,2021-10-28 08:00:00,28353.149999999998,1247.2300000000687
Sell,7,4095.34,2021-10-28 08:15:00,28667.38,29914.61000000007
Buy,7,4138.02,2021-10-28 08:45:00,28966.140000000003,948.4700000000666
Sell,7,4143.19,2021-10-28 09:00:00,29002.329999999998,29950.800000000065
Buy,7,4143.19,2021-10-28 09:00:00,29002.329999999998,948.4700000000666
Sell,7,4122.14,2021-10-28 09:15:00,28854.980000000003,29803.45000000007
Buy,7,4165.0,2021-10-28 09:45:00,29155.0,648.4500000000698
Sell,7,4159.88,2021-10-28 10:00:00,29119.16,29767.61000000007
Buy,7,4159.88,2021-10-28 10:00:00,29119.16,648.4500000000698
Sell,7,4164.83,2021-10-28 10:15:00,29153.809999999998,29802.260000000068
Buy,7,4159.11,2021-10-28 10:30:00,29113.769999999997,688.4900000000707
Sell,7,4150.24,2021-10-28 10:45:00,29051.68,29740.17000000007
Buy,7,4150.24,2021-10-28 10:45:00,29051.68,688.4900000000707
Sell,7,4132.6,2021-10-28 11:00:00,28928.200000000004,29616.690000000075
Buy,7,4132.6,2021-10-28 11:00:00,28928.200000000004,688.4900000000707
Sell,7,4134.99,2021-10-28 11:15:00,28944.93,29633.42000000007
Buy,7,4163.59,2021-10-28 12:00:00,29145.13,488.29000000007
Sell,7,4151.11,2021-10-28 12:15:00,29057.769999999997,29546.060000000067
Buy,7,4176.73,2021-10-28 12:45:00,29237.109999999997,308.95000000006985
Sell,7,4175.45,2021-10-28 13:00:00,29228.149999999998,29537.100000000068
Buy,7,4196.78,2021-10-28 13:15:00,29377.46,159.64000000006854
Sell,7,4184.09,2021-10-28 13:30:00,29288.63,29448.27000000007
Buy,7,4193.78,2021-10-28 13:45:00,29356.46,91.81000000007043
Sell,7,4182.15,2021-10-28 14:00:00,29275.049999999996,29366.860000000066
Buy,7,4182.15,2021-10-28 14:00:00,29275.049999999996,91.81000000007043
Sell,7,4165.69,2021-10-28 14:15:00,29159.829999999998,29251.64000000007
Buy,6,4191.18,2021-10-28 14:45:00,25147.08,4104.560000000067
Sell,6,4181.67,2021-10-28 15:00:00,25090.02,29194.580000000067
Buy,6,4181.67,2021-10-28 15:00:00,25090.02,4104.560000000067
Sell,6,4174.5,2021-10-28 15:15:00,25047.0,29151.560000000067
Buy,6,4174.5,2021-10-28 15:15:00,25047.0,4104.560000000067
Sell,6,4168.89,2021-10-28 15:30:00,25013.340000000004,29117.90000000007
Buy,6,4168.89,2021-10-28 15:30:00,25013.340000000004,4104.560000000067
Sell,6,4154.08,2021-10-28 15:45:00,24924.48,29029.040000000066
Buy,6,4186.58,2021-10-28 16:15:00,25119.48,3909.560000000067
Sell,6,4177.6,2021-10-28 16:30:00,25065.600000000002,28975.16000000007
Buy,6,4226.88,2021-10-28 17:15:00,25361.28,3613.88000000007
Sell,6,4224.36,2021-10-28 17:30:00,25346.159999999996,28960.040000000066
Buy,6,4226.83,2021-10-28 17:45:00,25360.98,3599.060000000067
Sell,6,4213.48,2021-10-28 18:00:00,25280.879999999997,28879.940000000064
Buy,6,4213.48,2021-10-28 18:00:00,25280.879999999997,3599.060000000067
Sell,6,4206.75,2021-10-28 18:15:00,25240.5,28839.560000000067
Buy,6,4206.75,2021-10-28 18:15:00,25240.5,3599.060000000067
Sell,6,4142.22,2021-10-28 18:30:00,24853.32,28452.380000000067
Buy,6,4181.8,2021-10-28 18:45:00,25090.800000000003,3361.5800000000636
Sell,6,4162.56,2021-10-28 19:00:00,24975.36,28336.940000000064
Buy,6,4207.67,2021-10-28 19:15:00,25246.02,3090.9200000000637
Sell,6,4234.4,2021-10-28 19:30:00,25406.399999999998,28497.32000000006
Buy,6,4280.55,2021-10-28 20:00:00,25683.300000000003,2814.0200000000586
Sell,6,4270.97,2021-10-28 20:15:00,25625.82,28439.84000000006
Buy,6,4273.99,2021-10-28 20:30:00,25643.94,2795.9000000000597
Sell,6,4255.17,2021-10-28 20:45:00,25531.02,28326.92000000006
Buy,6,4255.17,2021-10-28 20:45:00,25531.02,2795.9000000000597
Sell,6,4234.1,2021-10-28 21:00:00,25404.600000000002,28200.500000000062
Buy,6,4255.86,2021-10-28 21:45:00,25535.159999999996,2665.3400000000656
Sell,6,4249.23,2021-10-28 22:00:00,25495.379999999997,28160.720000000063
Buy,6,4263.49,2021-10-28 22:30:00,25580.94,2579.7800000000643
Sell,6,4253.82,2021-10-28 22:45:00,25522.92,28102.700000000063
Buy,6,4282.93,2021-10-28 23:15:00,25697.58,2405.120000000061
Sell,6,4271.18,2021-10-28 23:30:00,25627.08,28032.200000000063
Buy,6,4288.96,2021-10-28 23:45:00,25733.760000000002,2298.4400000000605
Sell,6,4281.81,2021-10-29 00:00:00,25690.86,27989.30000000006
Buy,6,4281.81,2021-10-29 00:00:00,25690.86,2298.4400000000605
Sell,6,4280.81,2021-10-29 00:15:00,25684.86,27983.30000000006
Buy,6,4303.68,2021-10-29 00:30:00,25822.08,2161.2200000000594
Sell,6,4359.05,2021-10-29 00:45:00,26154.300000000003,28315.520000000062
Buy,6,4359.05,2021-10-29 00:45:00,26154.300000000003,2161.2200000000594
Sell,6,4396.51,2021-10-29 01:00:00,26379.06,28540.28000000006
Buy,6,4396.51,2021-10-29 01:00:00,26379.06,2161.2200000000594
Sell,6,4399.95,2021-10-29 01:15:00,26399.699999999997,28560.920000000056
Buy,6,4399.95,2021-10-29 01:15:00,26399.699999999997,2161.2200000000594
Sell,6,4380.09,2021-10-29 01:30:00,26280.54,28441.76000000006
Buy,6,4380.09,2021-10-29 01:30:00,26280.54,2161.2200000000594
Sell,6,4358.15,2021-10-29 01:45:00,26148.899999999998,28310.120000000057
Buy,6,4384.03,2021-10-29 02:00:00,26304.18,2005.940000000057
Sell,6,4370.5,2021-10-29 02:15:00,26223.0,28228.940000000057
Buy,6,4370.5,2021-10-29 02:15:00,26223.0,2005.940000000057
Sell,6,4370.33,2021-10-29 02:30:00,26221.98,28227.920000000056
Buy,6,4404.48,2021-10-29 03:15:00,26426.879999999997,1801.040000000059
Sell,6,4374.31,2021-10-29 03:30:00,26245.86,28046.90000000006
Buy,6,4374.31,2021-10-29 03:30:00,26245.86,1801.040000000059
Sell,6,4383.84,2021-10-29 03:45:00,26303.04,28104.08000000006
Buy,6,4383.84,2021-10-29 03:45:00,26303.04,1801.040000000059
Sell,6,4371.58,2021-10-29 04:00:00,26229.48,28030.52000000006
Buy,6,4371.58,2021-10-29 04:00:00,26229.48,1801.040000000059
Sell,6,4377.3,2021-10-29 04:15:00,26263.800000000003,28064.840000000062
Buy,6,4377.3,2021-10-29 04:15:00,26263.800000000003,1801.040000000059
Sell,6,4354.0,2021-10-29 04:30:00,26124.0,27925.04000000006
Buy,6,4354.0,2021-10-29 04:30:00,26124.0,1801.040000000059
Sell,6,4357.87,2021-10-29 04:45:00,26147.22,27948.26000000006
Buy,6,4352.58,2021-10-29 05:00:00,26115.48,1832.7800000000607
Sell,6,4334.14,2021-10-29 05:15:00,26004.840000000004,27837.620000000064
Buy,6,4334.14,2021-10-29 05:15:00,26004.840000000004,1832.7800000000607
Sell,6,4311.72,2021-10-29 05:30:00,25870.32,27703.10000000006
Buy,6,4343.37,2021-10-29 06:00:00,26060.22,1642.8800000000592
Sell,6,4333.62,2021-10-29 06:15:00,26001.72,27644.60000000006
Buy,6,4353.24,2021-10-29 06:30:00,26119.44,1525.1600000000617
Sell,6,4345.31,2021-10-29 06:45:00,26071.86,27597.020000000062
Buy,6,4345.31,2021-10-29 06:45:00,26071.86,1525.1600000000617
Sell,6,4324.03,2021-10-29 07:00:00,25944.18,27469.340000000062
Buy,6,4324.03,2021-10-29 07:00:00,25944.18,1525.1600000000617
Sell,6,4319.41,2021-10-29 07:15:00,25916.46,27441.62000000006
Buy,6,4319.41,2021-10-29 07:15:00,25916.46,1525.1600000000617
Sell,6,4312.37,2021-10-29 07:30:00,25874.22,27399.380000000063
Buy,6,4312.37,2021-10-29 07:30:00,25874.22,1525.1600000000617
Sell,6,4312.78,2021-10-29 07:45:00,25876.68,27401.840000000062
Buy,6,4329.07,2021-10-29 08:00:00,25974.42,1427.4200000000637
Sell,6,4310.67,2021-10-29 08:15:00,25864.02,27291.440000000064
Buy,6,4310.67,2021-10-29 08:15:00,25864.02,1427.4200000000637
Sell,6,4312.9,2021-10-29 08:30:00,25877.399999999998,27304.82000000006
Buy,6,4361.15,2021-10-29 09:00:00,26166.899999999998,1137.9200000000637
Sell,6,4357.33,2021-10-29 09:15:00,26143.98,27281.900000000063
Buy,6,4357.33,2021-10-29 09:15:00,26143.98,1137.9200000000637
Sell,6,4339.92,2021-10-29 09:30:00,26039.52,27177.440000000064
Buy,6,4339.92,2021-10-29 09:30:00,26039.52,1137.9200000000637
Sell,6,4333.32,2021-10-29 09:45:00,25999.92,27137.840000000062
Buy,6,4335.39,2021-10-29 10:00:00,26012.340000000004,1125.5000000000582
Sell,6,4319.12,2021-10-29 10:15:00,25914.72,27040.22000000006
Buy,6,4335.79,2021-10-29 10:45:00,26014.739999999998,1025.4800000000614
Sell,6,4334.12,2021-10-29 11:00:00,26004.72,27030.200000000063
Buy,6,4334.12,2021-10-29 11:00:00,26004.72,1025.4800000000614
Sell,6,4331.93,2021-10-29 11:15:00,25991.58,27017.060000000063
Buy,6,4331.93,2021-10-29 11:15:00,25991.58,1025.4800000000614
Sell,6,4295.06,2021-10-29 11:30:00,25770.36,26795.840000000062
Buy,6,4323.18,2021-10-29 11:45:00,25939.08,856.7600000000602
Sell,6,4308.84,2021-10-29 12:00:00,25853.04,26709.80000000006
Buy,6,4337.04,2021-10-29 12:30:00,26022.239999999998,687.5600000000632
Sell,6,4317.5,2021-10-29 12:45:00,25905.0,26592.560000000063
Buy,6,4317.5,2021-10-29 12:45:00,25905.0,687.5600000000632
Sell,6,4305.47,2021-10-29 13:00:00,25832.82,26520.380000000063
Buy,6,4372.0,2021-10-29 13:45:00,26232.0,288.38000000006286
Sell,6,4355.16,2021-10-29 14:00:00,26130.96,26419.340000000062
Buy,6,4355.16,2021-10-29 14:00:00,26130.96,288.38000000006286
Sell,6,4332.61,2021-10-29 14:15:00,25995.659999999996,26284.04000000006
Buy,6,4332.61,2021-10-29 14:15:00,25995.659999999996,288.38000000006286
Sell,6,4343.64,2021-10-29 14:30:00,26061.840000000004,26350.220000000067
Buy,5,4394.61,2021-10-29 15:00:00,21973.05,4377.170000000067
Sell,5,4427.87,2021-10-29 15:15:00,22139.35,26516.520000000066
Buy,5,4427.87,2021-10-29 15:15:00,22139.35,4377.170000000067
Sell,5,4419.13,2021-10-29 15:30:00,22095.65,26472.82000000007
Buy,5,4444.33,2021-10-29 16:00:00,22221.65,4251.170000000067
Sell,5,4440.65,2021-10-29 16:15:00,22203.25,26454.420000000067
Buy,5,4440.65,2021-10-29 16:15:00,22203.25,4251.170000000067
Sell,5,4418.25,2021-10-29 16:30:00,22091.25,26342.420000000067
Buy,5,4418.25,2021-10-29 16:30:00,22091.25,4251.170000000067
Sell,5,4429.25,2021-10-29 16:45:00,22146.25,26397.420000000067
Buy,5,4437.96,2021-10-29 17:15:00,22189.8,4207.620000000068
Sell,5,4425.35,2021-10-29 17:30:00,22126.75,26334.370000000068
Buy,5,4425.35,2021-10-29 17:30:00,22126.75,4207.620000000068
Sell,5,4420.75,2021-10-29 17:45:00,22103.75,26311.370000000068
Buy,5,4425.79,2021-10-29 18:00:00,22128.95,4182.420000000067
Sell,5,4394.84,2021-10-29 18:15:00,21974.2,26156.620000000068
Buy,5,4394.84,2021-10-29 18:15:00,21974.2,4182.420000000067
Sell,5,4383.26,2021-10-29 18:30:00,21916.300000000003,26098.72000000007
Buy,5,4383.2,2021-10-29 19:15:00,21916.0,4182.72000000007
Sell,5,4375.33,2021-10-29 19:30:00,21876.65,26059.37000000007
Buy,5,4414.61,2021-10-29 20:00:00,22073.05,3986.3200000000725
Sell,5,4409.54,2021-10-29 20:15:00,22047.7,26034.020000000073
Buy,5,4414.62,2021-10-29 20:30:00,22073.1,3960.9200000000747
Sell,5,4402.75,2021-10-29 20:45:00,22013.75,25974.670000000075
Buy,5,4402.75,2021-10-29 20:45:00,22013.75,3960.9200000000747
Sell,5,4397.01,2021-10-29 21:00:00,21985.050000000003,25945.970000000078
Buy,5,4397.01,2021-10-29 21:00:00,21985.050000000003,3960.9200000000747
Sell,5,4395.26,2021-10-29 21:15:00,21976.300000000003,25937.220000000078
Buy,5,4419.31,2021-10-29 21:45:00,22096.550000000003,3840.6700000000747
Sell,5,4414.61,2021-10-29 22:00:00,22073.05,25913.720000000074
Buy,5,4414.61,2021-10-29 22:00:00,22073.05,3840.6700000000747
Sell,5,4403.23,2021-10-29 22:15:00,22016.149999999998,25856.820000000072
Buy,5,4419.22,2021-10-29 22:45:00,22096.100000000002,3760.7200000000703
Sell,5,4407.44,2021-10-29 23:00:00,22037.199999999997,25797.920000000067
Buy,5,4419.41,2021-10-29 23:15:00,22097.05,3700.870000000068
Sell,5,4405.71,2021-10-29 23:30:00,22028.55,25729.420000000067
Buy,5,4421.53,2021-10-29 23:45:00,22107.649999999998,3621.7700000000696
Sell,5,4389.9,2021-10-30 00:00:00,21949.5,25571.27000000007
Buy,5,4389.9,2021-10-30 00:00:00,21949.5,3621.7700000000696
Sell,5,4382.79,2021-10-30 00:15:00,21913.95,25535.72000000007
Buy,5,4382.79,2021-10-30 00:15:00,21913.95,3621.7700000000696
Sell,5,4382.04,2021-10-30 00:30:00,21910.2,25531.97000000007
Buy,5,4382.04,2021-10-30 00:30:00,21910.2,3621.7700000000696
Sell,5,4378.35,2021-10-30 00:45:00,21891.75,25513.52000000007
Buy,5,4389.5,2021-10-30 01:00:00,21947.5,3566.0200000000696
Sell,5,4356.72,2021-10-30 01:15:00,21783.600000000002,25349.62000000007
Buy,5,4380.65,2021-10-30 01:30:00,21903.25,3446.3700000000717
Sell,5,4364.72,2021-10-30 01:45:00,21823.600000000002,25269.970000000074
Buy,5,4364.72,2021-10-30 01:45:00,21823.600000000002,3446.3700000000717
Sell,5,4357.36,2021-10-30 02:00:00,21786.8,25233.17000000007
Buy,5,4366.01,2021-10-30 02:15:00,21830.050000000003,3403.120000000068
Sell,5,4363.89,2021-10-30 02:30:00,21819.45,25222.57000000007
Buy,5,4363.89,2021-10-30 02:30:00,21819.45,3403.120000000068
Sell,5,4363.59,2021-10-30 02:45:00,21817.95,25221.07000000007
Buy,5,4363.59,2021-10-30 02:45:00,21817.95,3403.120000000068
Sell,5,4356.14,2021-10-30 03:00:00,21780.7,25183.82000000007
Buy,5,4356.14,2021-10-30 03:00:00,21780.7,3403.120000000068
Sell,5,4339.0,2021-10-30 03:15:00,21695.0,25098.120000000068
Buy,5,4351.27,2021-10-30 03:30:00,21756.350000000002,3341.770000000066
Sell,5,4346.87,2021-10-30 03:45:00,21734.35,25076.120000000064
Buy,5,4360.42,2021-10-30 04:00:00,21802.1,3274.020000000066
Sell,5,4361.25,2021-10-30 04:15:00,21806.25,25080.270000000066
Buy,5,4361.25,2021-10-30 04:15:00,21806.25,3274.020000000066
Sell,5,4349.3,2021-10-30 04:30:00,21746.5,25020.520000000066
Buy,5,4349.3,2021-10-30 04:30:00,21746.5,3274.020000000066
Sell,5,4341.49,2021-10-30 04:45:00,21707.449999999997,24981.470000000063
Buy,5,4361.17,2021-10-30 05:15:00,21805.85,3175.6200000000645
Sell,5,4366.85,2021-10-30 05:30:00,21834.25,25009.870000000064
Buy,5,4366.85,2021-10-30 05:30:00,21834.25,3175.6200000000645
Sell,5,4361.3,2021-10-30 05:45:00,21806.5,24982.120000000064
Buy,5,4361.3,2021-10-30 05:45:00,21806.5,3175.6200000000645
Sell,5,4359.18,2021-10-30 06:00:00,21795.9,24971.520000000066
Buy,5,4368.7,2021-10-30 06:15:00,21843.5,3128.020000000066
Sell,5,4376.32,2021-10-30 06:30:00,21881.6,25009.620000000064
Buy,5,4376.32,2021-10-30 06:30:00,21881.6,3128.020000000066
Sell,5,4367.58,2021-10-30 06:45:00,21837.9,24965.920000000067
Buy,5,4367.58,2021-10-30 06:45:00,21837.9,3128.020000000066
Sell,5,4355.29,2021-10-30 07:00:00,21776.45,24904.470000000067
Buy,5,4355.29,2021-10-30 07:00:00,21776.45,3128.020000000066
Sell,5,4353.37,2021-10-30 07:15:00,21766.85,24894.870000000064
Buy,5,4353.37,2021-10-30 07:15:00,21766.85,3128.020000000066
Sell,5,4361.09,2021-10-30 07:30:00,21805.45,24933.470000000067
Buy,5,4361.09,2021-10-30 07:30:00,21805.45,3128.020000000066
Sell,5,4353.85,2021-10-30 07:45:00,21769.25,24897.270000000066
Buy,5,4353.85,2021-10-30 07:45:00,21769.25,3128.020000000066
Sell,5,4344.65,2021-10-30 08:00:00,21723.25,24851.270000000066
Buy,5,4344.65,2021-10-30 08:00:00,21723.25,3128.020000000066
Sell,5,4332.59,2021-10-30 08:15:00,21662.95,24790.970000000067
Buy,5,4332.59,2021-10-30 08:15:00,21662.95,3128.020000000066
Sell,5,4313.07,2021-10-30 08:30:00,21565.35,24693.370000000064
Buy,5,4322.75,2021-10-30 08:45:00,21613.75,3079.6200000000645
Sell,5,4325.2,2021-10-30 09:00:00,21626.0,24705.620000000064
Buy,5,4325.2,2021-10-30 09:00:00,21626.0,3079.6200000000645
Sell,5,4327.53,2021-10-30 09:15:00,21637.649999999998,24717.270000000062
Buy,5,4334.54,2021-10-30 09:30:00,21672.7,3044.5700000000616
Sell,5,4323.38,2021-10-30 09:45:00,21616.9,24661.470000000063
Buy,5,4323.38,2021-10-30 09:45:00,21616.9,3044.5700000000616
Sell,5,4314.25,2021-10-30 10:00:00,21571.25,24615.82000000006
Buy,5,4350.0,2021-10-30 10:45:00,21750.0,2865.8200000000616
Sell,5,4352.4,2021-10-30 11:00:00,21762.0,24627.82000000006
Buy,5,4352.4,2021-10-30 11:00:00,21762.0,2865.8200000000616
Sell,5,4341.94,2021-10-30 11:30:00,21709.699999999997,24575.52000000006
Buy,5,4341.94,2021-10-30 11:30:00,21709.699999999997,2865.8200000000616
Sell,5,4337.89,2021-10-30 11:45:00,21689.45,24555.270000000062
Buy,5,4337.89,2021-10-30 11:45:00,21689.45,2865.8200000000616
Sell,5,4326.31,2021-10-30 12:00:00,21631.550000000003,24497.370000000064
Buy,5,4326.31,2021-10-30 12:00:00,21631.550000000003,2865.8200000000616
Sell,5,4332.32,2021-10-30 12:15:00,21661.6,24527.42000000006
Buy,5,4332.32,2021-10-30 12:15:00,21661.6,2865.8200000000616
Sell,5,4321.26,2021-10-30 12:30:00,21606.300000000003,24472.120000000064
Buy,5,4321.26,2021-10-30 12:30:00,21606.300000000003,2865.8200000000616
Sell,5,4329.0,2021-10-30 12:45:00,21645.0,24510.82000000006
Buy,5,4329.0,2021-10-30 12:45:00,21645.0,2865.8200000000616
Sell,5,4312.24,2021-10-30 13:00:00,21561.199999999997,24427.02000000006
Buy,5,4312.24,2021-10-30 13:00:00,21561.199999999997,2865.8200000000616
Sell,5,4324.08,2021-10-30 13:15:00,21620.4,24486.220000000063
Buy,5,4324.08,2021-10-30 13:15:00,21620.4,2865.8200000000616
Sell,5,4316.11,2021-10-30 13:30:00,21580.55,24446.37000000006
Buy,5,4316.11,2021-10-30 13:30:00,21580.55,2865.8200000000616
Sell,5,4313.75,2021-10-30 13:45:00,21568.75,24434.57000000006
Buy,5,4312.0,2021-10-30 14:00:00,21560.0,2874.5700000000616
Sell,5,4271.88,2021-10-30 14:15:00,21359.4,24233.970000000063
Buy,5,4271.88,2021-10-30 14:15:00,21359.4,2874.5700000000616
Sell,5,4276.71,2021-10-30 14:45:00,21383.55,24258.12000000006
Buy,5,4291.97,2021-10-30 15:00:00,21459.850000000002,2798.2700000000586
Sell,5,4285.27,2021-10-30 15:15:00,21426.350000000002,24224.62000000006
Buy,5,4285.27,2021-10-30 15:15:00,21426.350000000002,2798.2700000000586
Sell,5,4286.67,2021-10-30 15:30:00,21433.35,24231.620000000057
Buy,5,4286.67,2021-10-30 15:30:00,21433.35,2798.2700000000586
Sell,5,4284.53,2021-10-30 15:45:00,21422.649999999998,24220.920000000056
Buy,5,4292.06,2021-10-30 16:00:00,21460.300000000003,2760.6200000000536
Sell,5,4285.96,2021-10-30 16:15:00,21429.8,24190.420000000053
Buy,5,4285.96,2021-10-30 16:15:00,21429.8,2760.6200000000536
Sell,5,4275.67,2021-10-30 16:30:00,21378.35,24138.970000000052
Buy,5,4287.88,2021-10-30 16:45:00,21439.4,2699.5700000000506
Sell,5,4286.06,2021-10-30 17:00:00,21430.300000000003,24129.870000000054
Buy,5,4296.57,2021-10-30 17:30:00,21482.85,2647.020000000055
Sell,5,4304.89,2021-10-30 17:45:00,21524.45,24171.470000000056
Buy,5,4307.11,2021-10-30 18:00:00,21535.55,2635.9200000000565
Sell,5,4305.26,2021-10-30 18:15:00,21526.300000000003,24162.22000000006
Buy,5,4305.26,2021-10-30 18:15:00,21526.300000000003,2635.9200000000565
Sell,5,4306.77,2021-10-30 18:30:00,21533.850000000002,24169.77000000006
Buy,5,4325.37,2021-10-30 18:45:00,21626.85,2542.92000000006
Sell,5,4327.63,2021-10-30 19:00:00,21638.15,24181.07000000006
Buy,5,4327.63,2021-10-30 19:00:00,21638.15,2542.92000000006
Sell,5,4329.64,2021-10-30 19:15:00,21648.2,24191.12000000006
Buy,5,4329.64,2021-10-30 19:15:00,21648.2,2542.92000000006
Sell,5,4336.96,2021-10-30 19:30:00,21684.8,24227.72000000006
Buy,5,4336.96,2021-10-30 19:30:00,21684.8,2542.92000000006
Sell,5,4338.85,2021-10-30 19:45:00,21694.25,24237.17000000006
Buy,5,4338.85,2021-10-30 19:45:00,21694.25,2542.92000000006
Sell,5,4344.68,2021-10-30 20:00:00,21723.4,24266.32000000006
Buy,5,4344.68,2021-10-30 20:00:00,21723.4,2542.92000000006
Sell,5,4332.22,2021-10-30 20:15:00,21661.100000000002,24204.020000000062
Buy,5,4332.22,2021-10-30 20:15:00,21661.100000000002,2542.92000000006
Sell,5,4319.4,2021-10-30 20:30:00,21597.0,24139.92000000006
Buy,5,4319.4,2021-10-30 20:30:00,21597.0,2542.92000000006
Sell,5,4311.76,2021-10-30 20:45:00,21558.800000000003,24101.720000000063
Buy,5,4311.76,2021-10-30 20:45:00,21558.800000000003,2542.92000000006
Sell,5,4306.95,2021-10-30 21:00:00,21534.75,24077.67000000006
Buy,5,4306.95,2021-10-30 21:00:00,21534.75,2542.92000000006
Sell,5,4291.08,2021-10-30 21:15:00,21455.4,23998.32000000006
Buy,5,4300.67,2021-10-30 21:30:00,21503.35,2494.970000000063
Sell,5,4286.6,2021-10-30 21:45:00,21433.0,23927.970000000063
Buy,5,4277.03,2021-10-30 22:15:00,21385.149999999998,2542.820000000065
Sell,5,4263.5,2021-10-30 22:30:00,21317.5,23860.320000000065
Buy,5,4290.06,2021-10-30 22:45:00,21450.300000000003,2410.0200000000623
Sell,5,4307.2,2021-10-30 23:00:00,21536.0,23946.020000000062
Buy,5,4307.2,2021-10-30 23:00:00,21536.0,2410.0200000000623
Sell,5,4295.78,2021-10-30 23:15:00,21478.899999999998,23888.92000000006
Buy,5,4376.52,2021-10-31 00:15:00,21882.600000000002,2006.320000000058
Sell,5,4385.03,2021-10-31 00:30:00,21925.149999999998,23931.470000000056
Buy,5,4388.0,2021-10-31 00:45:00,21940.0,1991.4700000000557
Sell,5,4384.25,2021-10-31 01:00:00,21921.25,23912.720000000056
Buy,5,4384.25,2021-10-31 01:00:00,21921.25,1991.4700000000557
Sell,5,4361.58,2021-10-31 01:15:00,21807.9,23799.370000000057
Buy,5,4361.58,2021-10-31 01:15:00,21807.9,1991.4700000000557
Sell,5,4360.33,2021-10-31 01:30:00,21801.65,23793.120000000057
Buy,5,4394.15,2021-10-31 02:15:00,21970.75,1822.3700000000572
Sell,5,4379.39,2021-10-31 02:30:00,21896.95,23719.320000000058
Buy,5,4379.39,2021-10-31 02:30:00,21896.95,1822.3700000000572
Sell,5,4368.6,2021-10-31 02:45:00,21843.0,23665.370000000057
Buy,5,4368.6,2021-10-31 02:45:00,21843.0,1822.3700000000572
Sell,5,4362.0,2021-10-31 03:00:00,21810.0,23632.370000000057
Buy,5,4379.56,2021-10-31 03:30:00,21897.800000000003,1734.5700000000543
Sell,5,4373.52,2021-10-31 03:45:00,21867.600000000002,23602.170000000056
Buy,5,4373.52,2021-10-31 03:45:00,21867.600000000002,1734.5700000000543
Sell,5,4367.18,2021-10-31 04:00:00,21835.9,23570.470000000056
Buy,5,4382.29,2021-10-31 04:30:00,21911.45,1659.020000000055
Sell,5,4370.19,2021-10-31 04:45:00,21850.949999999997,23509.970000000052
Buy,5,4370.19,2021-10-31 04:45:00,21850.949999999997,1659.020000000055
Sell,5,4349.11,2021-10-31 05:00:00,21745.55,23404.570000000054
Buy,5,4349.11,2021-10-31 05:00:00,21745.55,1659.020000000055
Sell,5,4324.31,2021-10-31 05:15:00,21621.550000000003,23280.570000000058
Buy,5,4324.31,2021-10-31 05:15:00,21621.550000000003,1659.020000000055
Sell,5,4325.76,2021-10-31 05:30:00,21628.800000000003,23287.820000000058
Buy,5,4330.58,2021-10-31 05:45:00,21652.9,1634.9200000000565
Sell,5,4318.16,2021-10-31 06:00:00,21590.8,23225.720000000056
Buy,5,4318.16,2021-10-31 06:00:00,21590.8,1634.9200000000565
Sell,5,4315.43,2021-10-31 06:15:00,21577.15,23212.070000000058
Buy,5,4315.43,2021-10-31 06:15:00,21577.15,1634.9200000000565
Sell,5,4304.9,2021-10-31 06:30:00,21524.5,23159.420000000056
Buy,5,4332.69,2021-10-31 07:15:00,21663.449999999997,1495.9700000000594
Sell,5,4322.78,2021-10-31 07:30:00,21613.899999999998,23109.870000000057
Buy,5,4322.78,2021-10-31 07:30:00,21613.899999999998,1495.9700000000594
Sell,5,4320.97,2021-10-31 07:45:00,21604.850000000002,23100.82000000006
Buy,5,4320.97,2021-10-31 07:45:00,21604.850000000002,1495.9700000000594
Sell,5,4307.77,2021-10-31 08:00:00,21538.850000000002,23034.82000000006
Buy,5,4307.77,2021-10-31 08:00:00,21538.850000000002,1495.9700000000594
Sell,5,4290.72,2021-10-31 08:15:00,21453.600000000002,22949.57000000006
Buy,5,4290.72,2021-10-31 08:15:00,21453.600000000002,1495.9700000000594
Sell,5,4268.0,2021-10-31 08:30:00,21340.0,22835.97000000006
Buy,5,4274.72,2021-10-31 08:45:00,21373.600000000002,1462.3700000000572
Sell,5,4259.24,2021-10-31 09:00:00,21296.199999999997,22758.570000000054
Buy,5,4259.24,2021-10-31 09:00:00,21296.199999999997,1462.3700000000572
Sell,5,4274.31,2021-10-31 09:15:00,21371.550000000003,22833.92000000006
Buy,5,4274.31,2021-10-31 09:15:00,21371.550000000003,1462.3700000000572
Sell,5,4263.82,2021-10-31 09:30:00,21319.1,22781.470000000056
Buy,5,4263.82,2021-10-31 09:30:00,21319.1,1462.3700000000572
Sell,5,4262.44,2021-10-31 09:45:00,21312.199999999997,22774.570000000054
Buy,5,4262.44,2021-10-31 09:45:00,21312.199999999997,1462.3700000000572
Sell,5,4243.5,2021-10-31 10:00:00,21217.5,22679.870000000057
Buy,5,4281.59,2021-10-31 10:30:00,21407.95,1271.9200000000565
Sell,5,4254.11,2021-10-31 10:45:00,21270.55,22542.470000000056
Buy,5,4254.11,2021-10-31 10:45:00,21270.55,1271.9200000000565
Sell,5,4250.99,2021-10-31 11:00:00,21254.949999999997,22526.870000000054
Buy,5,4242.57,2021-10-31 11:15:00,21212.85,1314.020000000055
Sell,5,4210.15,2021-10-31 11:30:00,21050.75,22364.770000000055
Buy,5,4210.15,2021-10-31 11:30:00,21050.75,1314.020000000055
Sell,5,4209.95,2021-10-31 11:45:00,21049.75,22363.770000000055
Buy,5,4205.23,2021-10-31 12:00:00,21026.149999999998,1337.6200000000572
Sell,5,4210.93,2021-10-31 12:15:00,21054.65,22392.27000000006
Buy,5,4210.93,2021-10-31 12:15:00,21054.65,1337.6200000000572
Sell,5,4196.02,2021-10-31 12:30:00,20980.100000000002,22317.72000000006
Buy,5,4196.02,2021-10-31 12:30:00,20980.100000000002,1337.6200000000572
Sell,5,4189.28,2021-10-31 12:45:00,20946.399999999998,22284.020000000055
Buy,5,4215.38,2021-10-31 13:00:00,21076.9,1207.1200000000536
Sell,5,4198.79,2021-10-31 13:15:00,20993.95,22201.070000000054
Buy,5,4198.79,2021-10-31 13:15:00,20993.95,1207.1200000000536
Sell,5,4206.47,2021-10-31 13:30:00,21032.350000000002,22239.470000000056
Buy,5,4228.15,2021-10-31 14:15:00,21140.75,1098.7200000000557
Sell,5,4200.9,2021-10-31 14:30:00,21004.5,22103.220000000056
Buy,5,4200.9,2021-10-31 14:30:00,21004.5,1098.7200000000557
Sell,5,4208.34,2021-10-31 14:45:00,21041.7,22140.420000000056
Buy,5,4227.1,2021-10-31 15:15:00,21135.5,1004.9200000000565
Sell,5,4214.64,2021-10-31 15:30:00,21073.2,22078.120000000057
Buy,5,4214.64,2021-10-31 15:30:00,21073.2,1004.9200000000565
Sell,5,4216.54,2021-10-31 15:45:00,21082.7,22087.620000000057
Buy,5,4216.54,2021-10-31 15:45:00,21082.7,1004.9200000000565
Sell,5,4199.7,2021-10-31 16:00:00,20998.5,22003.420000000056
Buy,5,4261.21,2021-10-31 17:15:00,21306.05,697.3700000000572
Sell,5,4248.99,2021-10-31 17:30:00,21244.949999999997,21942.320000000054
Buy,5,4248.99,2021-10-31 17:30:00,21244.949999999997,697.3700000000572
Sell,5,4244.03,2021-10-31 17:45:00,21220.149999999998,21917.520000000055
Buy,5,4244.03,2021-10-31 17:45:00,21220.149999999998,697.3700000000572
Sell,5,4232.03,2021-10-31 18:00:00,21160.149999999998,21857.520000000055
Buy,5,4232.03,2021-10-31 18:00:00,21160.149999999998,697.3700000000572
Sell,5,4225.69,2021-10-31 18:15:00,21128.449999999997,21825.820000000054
Buy,5,4253.0,2021-10-31 18:45:00,21265.0,560.8200000000543
Sell,5,4256.44,2021-10-31 19:00:00,21282.199999999997,21843.02000000005
Buy,5,4256.44,2021-10-31 19:00:00,21282.199999999997,560.8200000000543
Sell,5,4260.55,2021-10-31 19:15:00,21302.75,21863.570000000054
Buy,5,4260.55,2021-10-31 19:15:00,21302.75,560.8200000000543
Sell,5,4252.62,2021-10-31 19:30:00,21263.1,21823.920000000053
Buy,5,4252.62,2021-10-31 19:30:00,21263.1,560.8200000000543
Sell,5,4250.42,2021-10-31 19:45:00,21252.1,21812.920000000053
Buy,5,4269.84,2021-10-31 20:30:00,21349.2,463.7200000000521
Sell,5,4267.36,2021-10-31 20:45:00,21336.8,21800.52000000005
Buy,5,4267.36,2021-10-31 20:45:00,21336.8,463.7200000000521
Sell,5,4270.65,2021-10-31 21:00:00,21353.25,21816.970000000052
Buy,5,4313.81,2021-10-31 21:30:00,21569.050000000003,247.92000000004919
Sell,5,4310.05,2021-10-31 21:45:00,21550.25,21798.17000000005
Buy,5,4310.05,2021-10-31 21:45:00,21550.25,247.92000000004919
Sell,5,4298.51,2021-10-31 22:00:00,21492.550000000003,21740.470000000052
Buy,5,4309.54,2021-10-31 22:15:00,21547.7,192.77000000005137
Sell,5,4300.72,2021-10-31 22:30:00,21503.600000000002,21696.370000000054
Buy,5,4300.72,2021-10-31 22:30:00,21503.600000000002,192.77000000005137
Sell,5,4295.77,2021-10-31 22:45:00,21478.850000000002,21671.620000000054
Buy,5,4295.77,2021-10-31 22:45:00,21478.850000000002,192.77000000005137
Sell,5,4281.19,2021-10-31 23:00:00,21405.949999999997,21598.72000000005
Buy,5,4297.77,2021-10-31 23:30:00,21488.850000000002,109.87000000004628
Sell,5,4288.86,2021-10-31 23:45:00,21444.3,21554.170000000046
Buy,5,4288.86,2021-10-31 23:45:00,21444.3,109.87000000004628
Sell,5,2484.77,2021-11-06 00:00:00,12423.85,12533.720000000047
Buy,4,2613.15,2021-11-06 02:30:00,10452.6,2081.1200000000463
Sell,4,2437.88,2021-11-06 02:45:00,9751.52,11832.640000000047
Buy,4,2437.88,2021-11-06 02:45:00,9751.52,2081.1200000000463
Sell,4,2457.63,2021-11-06 03:00:00,9830.52,11911.640000000047
Buy,4,2454.77,2021-11-06 03:15:00,9819.08,2092.560000000047
Sell,4,2462.85,2021-11-06 03:30:00,9851.4,11943.960000000046
Buy,4,2468.98,2021-11-06 04:00:00,9875.92,2068.0400000000463
Sell,4,2459.91,2021-11-06 04:15:00,9839.64,11907.680000000046
Buy,4,2613.15,2021-11-06 04:30:00,10452.6,1455.0800000000454
Sell,4,2478.44,2021-11-06 04:45:00,9913.76,11368.840000000046
Buy,4,2478.44,2021-11-06 04:45:00,9913.76,1455.0800000000454
Sell,4,2485.48,2021-11-06 05:00:00,9941.92,11397.000000000045
Buy,4,2474.3,2021-11-06 05:15:00,9897.2,1499.8000000000447
Sell,4,2465.85,2021-11-06 05:45:00,9863.4,11363.200000000044
Buy,4,2442.63,2021-11-06 06:15:00,9770.52,1592.680000000044
Sell,4,2437.81,2021-11-06 06:30:00,9751.24,11343.920000000044
Buy,4,2437.81,2021-11-06 06:30:00,9751.24,1592.680000000044
Sell,4,2428.08,2021-11-06 06:45:00,9712.32,11305.000000000044
Buy,4,2613.15,2021-11-06 07:00:00,10452.6,852.4000000000433
Sell,4,2435.2,2021-11-06 07:15:00,9740.8,10593.200000000043
Buy,4,2435.2,2021-11-06 07:15:00,9740.8,852.4000000000433
Sell,4,2443.32,2021-11-06 07:30:00,9773.28,10625.680000000044
Buy,4,2464.93,2021-11-06 08:15:00,9859.72,765.9600000000446
Sell,4,2448.42,2021-11-06 08:30:00,9793.68,10559.640000000045
Buy,4,2448.42,2021-11-06 08:30:00,9793.68,765.9600000000446
Sell,4,2442.49,2021-11-06 08:45:00,9769.96,10535.920000000044
Buy,4,2469.61,2021-11-06 09:15:00,9878.44,657.4800000000432
Sell,4,2464.6,2021-11-06 09:30:00,9858.4,10515.880000000043
Buy,4,2464.6,2021-11-06 09:30:00,9858.4,657.4800000000432
Sell,4,2457.21,2021-11-06 09:45:00,9828.84,10486.320000000043
Buy,4,2482.61,2021-11-06 10:30:00,9930.44,555.8800000000429
Sell,4,2472.82,2021-11-06 10:45:00,9891.28,10447.160000000044
Buy,4,2472.82,2021-11-06 10:45:00,9891.28,555.8800000000429
Sell,4,2462.71,2021-11-06 11:15:00,9850.84,10406.720000000043
Buy,4,2465.38,2021-11-06 11:30:00,9861.52,545.2000000000426
Sell,4,2468.92,2021-11-06 11:45:00,9875.68,10420.880000000043
Buy,4,2468.92,2021-11-06 11:45:00,9875.68,545.2000000000426
Sell,4,2455.24,2021-11-06 12:00:00,9820.96,10366.160000000042
Buy,4,2455.24,2021-11-06 12:00:00,9820.96,545.2000000000426
Sell,4,2456.63,2021-11-06 12:15:00,9826.52,10371.720000000043
Buy,4,2457.55,2021-11-06 12:30:00,9830.2,541.5200000000423
Sell,4,2456.6,2021-11-06 12:45:00,9826.4,10367.920000000042
Buy,4,2470.38,2021-11-06 13:15:00,9881.52,486.4000000000415
Sell,4,2473.29,2021-11-06 13:30:00,9893.16,10379.560000000041
Buy,4,2473.29,2021-11-06 13:30:00,9893.16,486.4000000000415
Sell,4,2472.75,2021-11-06 13:45:00,9891.0,10377.400000000041
Buy,4,2472.75,2021-11-06 13:45:00,9891.0,486.4000000000415
Sell,4,2459.46,2021-11-06 14:00:00,9837.84,10324.240000000042
Buy,3,2613.15,2021-11-06 14:15:00,7839.450000000001,2484.790000000041
Sell,3,2455.16,2021-11-06 14:30:00,7365.48,9850.27000000004
Buy,4,2455.16,2021-11-06 14:30:00,9820.64,29.630000000041036
Sell,4,2446.38,2021-11-06 14:45:00,9785.52,9815.150000000041
Buy,3,2613.15,2021-11-06 16:00:00,7839.450000000001,1975.7000000000407
Sell,3,2402.3,2021-11-06 16:15:00,7206.900000000001,9182.600000000042
Buy,3,2402.3,2021-11-06 16:15:00,7206.900000000001,1975.7000000000417
Sell,3,2377.79,2021-11-06 16:30:00,7133.37,9109.070000000042
Buy,3,2385.52,2021-11-06 17:00:00,7156.5599999999995,1952.510000000042
Sell,3,2395.81,2021-11-06 17:15:00,7187.43,9139.940000000042
Buy,3,2613.15,2021-11-06 17:45:00,7839.450000000001,1300.4900000000416
Sell,3,2392.46,2021-11-06 18:00:00,7177.38,8477.870000000043
Buy,3,2392.46,2021-11-06 18:00:00,7177.38,1300.4900000000425
Sell,3,2389.93,2021-11-06 18:15:00,7169.789999999999,8470.280000000042
Buy,3,2415.0,2021-11-06 18:45:00,7245.0,1225.2800000000425
Sell,3,2408.71,2021-11-06 19:15:00,7226.13,8451.410000000044
Buy,3,2408.71,2021-11-06 19:15:00,7226.13,1225.2800000000434
Sell,3,2402.55,2021-11-06 19:30:00,7207.650000000001,8432.930000000044
Buy,3,2404.92,2021-11-06 20:15:00,7214.76,1218.1700000000437
Sell,3,2398.35,2021-11-06 20:30:00,7195.049999999999,8413.220000000043
Buy,3,2398.35,2021-11-06 20:30:00,7195.049999999999,1218.1700000000437
Sell,3,2381.04,2021-11-06 20:45:00,7143.12,8361.290000000045
Buy,3,2378.68,2021-11-06 21:00:00,7136.039999999999,1225.2500000000455
Sell,3,2352.02,2021-11-06 21:15:00,7056.0599999999995,8281.310000000045
Buy,3,2352.02,2021-11-06 21:15:00,7056.0599999999995,1225.2500000000455
Sell,3,2333.02,2021-11-06 21:30:00,6999.0599999999995,8224.310000000045
Buy,3,2360.62,2021-11-06 22:45:00,7081.86,1142.4500000000453
Sell,3,2349.71,2021-11-06 23:00:00,7049.13,8191.580000000045
Buy,3,2349.71,2021-11-06 23:00:00,7049.13,1142.4500000000453
Sell,3,2332.73,2021-11-06 23:15:00,6998.1900000000005,8140.640000000046
Buy,3,2613.15,2021-11-06 23:45:00,7839.450000000001,301.1900000000451
Sell,3,2130.44,2021-11-07 00:00:00,6391.32,6692.510000000045
Buy,3,2091.44,2021-11-07 03:15:00,6274.32,418.1900000000451
Sell,3,2089.29,2021-11-07 03:30:00,6267.87,6686.060000000045
Buy,3,2089.29,2021-11-07 03:30:00,6267.87,418.1900000000451
Sell,3,2090.12,2021-11-07 03:45:00,6270.36,6688.550000000045
Buy,3,2090.12,2021-11-07 03:45:00,6270.36,418.1900000000451
Sell,3,2084.12,2021-11-07 04:00:00,6252.36,6670.550000000045
Buy,3,2084.12,2021-11-07 04:00:00,6252.36,418.1900000000451
Sell,3,2083.92,2021-11-07 04:15:00,6251.76,6669.950000000045
Buy,3,2096.3,2021-11-07 05:00:00,6288.900000000001,381.05000000004475
Sell,3,2095.96,2021-11-07 05:15:00,6287.88,6668.930000000045
Buy,3,2100.32,2021-11-07 05:30:00,6300.960000000001,367.9700000000439
Sell,3,2099.38,2021-11-07 05:45:00,6298.14,6666.110000000044
Buy,3,2104.14,2021-11-07 06:00:00,6312.42,353.69000000004417
Sell,3,2096.72,2021-11-07 06:15:00,6290.16,6643.850000000044
Buy,3,2096.72,2021-11-07 06:15:00,6290.16,353.69000000004417
Sell,3,2093.56,2021-11-07 06:30:00,6280.68,6634.3700000000445
Buy,3,2093.56,2021-11-07 06:30:00,6280.68,353.69000000004417
Sell,3,2090.46,2021-11-07 06:45:00,6271.38,6625.070000000044
Buy,3,2090.46,2021-11-07 06:45:00,6271.38,353.69000000004417
Sell,3,2088.39,2021-11-07 07:00:00,6265.17,6618.860000000044
Buy,3,2099.34,2021-11-07 07:30:00,6298.02,320.8400000000438
Sell,3,2099.22,2021-11-07 07:45:00,6297.66,6618.500000000044
Buy,3,2099.22,2021-11-07 07:45:00,6297.66,320.8400000000438
Sell,3,2095.09,2021-11-07 08:00:00,6285.27,6606.110000000044
Buy,3,2118.4,2021-11-07 08:30:00,6355.200000000001,250.9100000000435
Sell,3,2111.47,2021-11-07 08:45:00,6334.41,6585.320000000043
Buy,3,2124.86,2021-11-07 09:15:00,6374.58,210.74000000004344
Sell,3,2120.78,2021-11-07 09:30:00,6362.34,6573.080000000044
Buy,3,2120.78,2021-11-07 09:30:00,6362.34,210.74000000004344
Sell,3,2119.02,2021-11-07 09:45:00,6357.0599999999995,6567.800000000043
Buy,3,2124.89,2021-11-07 10:00:00,6374.67,193.13000000004286
Sell,3,2118.94,2021-11-07 10:15:00,6356.82,6549.950000000043
Buy,3,2118.94,2021-11-07 10:15:00,6356.82,193.13000000004286
Sell,3,2114.79,2021-11-07 10:30:00,6344.37,6537.500000000043
Buy,3,2120.16,2021-11-07 10:45:00,6360.48,177.02000000004318
Sell,3,2118.57,2021-11-07 11:00:00,6355.710000000001,6532.730000000044
Buy,3,2128.86,2021-11-07 11:45:00,6386.58,146.1500000000442
Sell,3,2122.51,2021-11-07 12:00:00,6367.530000000001,6513.680000000045
Buy,3,2122.51,2021-11-07 12:00:00,6367.530000000001,146.1500000000442
Sell,3,2123.37,2021-11-07 12:15:00,6370.11,6516.260000000044
Buy,3,2124.62,2021-11-07 12:30:00,6373.86,142.4000000000442
Sell,3,2123.2,2021-11-07 12:45:00,6369.599999999999,6512.000000000044
Buy,3,2123.2,2021-11-07 12:45:00,6369.599999999999,142.4000000000442
Sell,3,2119.51,2021-11-07 13:00:00,6358.530000000001,6500.930000000045
Buy,3,2134.9,2021-11-07 13:45:00,6404.700000000001,96.23000000004413
Sell,3,2132.0,2021-11-07 14:00:00,6396.0,6492.230000000044
Buy,3,2132.0,2021-11-07 14:00:00,6396.0,96.23000000004413
Sell,3,2130.21,2021-11-07 14:15:00,6390.63,6486.860000000044
Buy,3,2145.44,2021-11-07 14:45:00,6436.32,50.54000000004453
Sell,3,2141.8,2021-11-07 15:00:00,6425.400000000001,6475.940000000045
Buy,3,2139.71,2021-11-07 15:15:00,6419.13,56.810000000044965
Sell,3,2137.0,2021-11-07 15:30:00,6411.0,6467.810000000045
Buy,3,2144.75,2021-11-07 15:45:00,6434.25,33.560000000044965
Sell,3,2135.66,2021-11-07 16:00:00,6406.98,6440.5400000000445
Buy,3,2145.66,2021-11-07 16:30:00,6436.98,3.5600000000449654
Sell,3,2148.58,2021-11-07 16:45:00,6445.74,6449.300000000045
Buy,3,2148.58,2021-11-07 16:45:00,6445.74,3.5600000000449654
Sell,3,2143.09,2021-11-07 17:00:00,6429.27,6432.830000000045
Buy,3,2143.09,2021-11-07 17:00:00,6429.27,3.5600000000449654
Sell,3,2146.23,2021-11-07 17:15:00,6438.6900000000005,6442.2500000000455
Buy,3,2146.23,2021-11-07 17:15:00,6438.6900000000005,3.5600000000449654
Sell,3,2141.16,2021-11-07 17:30:00,6423.48,6427.0400000000445
Buy,3,2141.16,2021-11-07 17:30:00,6423.48,3.5600000000449654
Sell,3,2141.77,2021-11-07 17:45:00,6425.3099999999995,6428.8700000000445
Buy,3,2141.77,2021-11-07 17:45:00,6425.3099999999995,3.5600000000449654
Sell,3,2136.65,2021-11-07 18:00:00,6409.950000000001,6413.510000000046
Buy,3,2136.65,2021-11-07 18:00:00,6409.950000000001,3.5600000000449654
Sell,3,2139.27,2021-11-07 18:15:00,6417.8099999999995,6421.3700000000445
Buy,2,2142.14,2021-11-07 18:45:00,4284.28,2137.0900000000447
Sell,2,2140.55,2021-11-07 19:00:00,4281.1,6418.190000000045
Buy,2,2140.55,2021-11-07 19:00:00,4281.1,2137.0900000000447
Sell,2,2135.5,2021-11-07 19:15:00,4271.0,6408.090000000045
Buy,2,2137.65,2021-11-07 19:30:00,4275.3,2132.7900000000445
Sell,2,2134.61,2021-11-07 19:45:00,4269.22,6402.010000000045
Buy,2,2138.35,2021-11-07 20:00:00,4276.7,2125.310000000045
Sell,2,2134.25,2021-11-07 20:15:00,4268.5,6393.810000000045
Buy,2,2134.25,2021-11-07 20:15:00,4268.5,2125.310000000045
Sell,2,2132.92,2021-11-07 20:30:00,4265.84,6391.150000000045
Buy,2,2132.92,2021-11-07 20:30:00,4265.84,2125.310000000045
Sell,2,2129.31,2021-11-07 20:45:00,4258.62,6383.930000000045
Buy,2,2129.31,2021-11-07 20:45:00,4258.62,2125.310000000045
Sell,2,2131.8,2021-11-07 21:00:00,4263.6,6388.910000000045
Buy,2,2165.42,2021-11-07 21:45:00,4330.84,2058.070000000045
Sell,2,2165.04,2021-11-07 22:00:00,4330.08,6388.150000000045
Buy,2,2165.04,2021-11-07 22:00:00,4330.08,2058.070000000045
Sell,2,2158.42,2021-11-07 22:15:00,4316.84,6374.910000000045
Buy,2,2158.42,2021-11-07 22:15:00,4316.84,2058.070000000045
Sell,2,2152.45,2021-11-07 22:30:00,4304.9,6362.970000000045
Buy,2,2152.45,2021-11-07 22:30:00,4304.9,2058.070000000045
Sell,2,2149.13,2021-11-07 22:45:00,4298.26,6356.330000000045
Buy,2,2149.13,2021-11-07 22:45:00,4298.26,2058.070000000045
Sell,2,2139.12,2021-11-07 23:00:00,4278.24,6336.310000000045
Buy,2,2139.12,2021-11-07 23:00:00,4278.24,2058.070000000045
Sell,2,2139.79,2021-11-07 23:15:00,4279.58,6337.650000000045
Buy,2,3163.08,2021-11-08 00:00:00,6326.16,11.490000000045256
Sell,2,3153.6,2021-11-08 00:15:00,6307.2,6318.690000000045
Buy,2,3153.6,2021-11-08 00:15:00,6307.2,11.490000000045256
Sell,2,3162.88,2021-11-08 00:30:00,6325.76,6337.2500000000455
Buy,2,3162.88,2021-11-08 00:30:00,6325.76,11.490000000045256
Sell,2,3170.61,2021-11-08 00:45:00,6341.22,6352.7100000000455
Buy,2,3170.61,2021-11-08 00:45:00,6341.22,11.490000000045256
Sell,2,3168.02,2021-11-08 01:00:00,6336.04,6347.530000000045
Buy,2,3168.02,2021-11-08 01:00:00,6336.04,11.490000000045256
Sell,2,3183.84,2021-11-08 01:15:00,6367.68,6379.170000000046
Buy,2,3183.84,2021-11-08 01:15:00,6367.68,11.490000000045256
Sell,2,3173.26,2021-11-08 01:30:00,6346.52,6358.010000000046
Buy,2,3173.26,2021-11-08 01:30:00,6346.52,11.490000000045256
Sell,2,3173.61,2021-11-08 01:45:00,6347.22,6358.7100000000455
Buy,2,3173.61,2021-11-08 01:45:00,6347.22,11.490000000045256
Sell,2,3173.56,2021-11-08 02:00:00,6347.12,6358.610000000045
Buy,2,3173.56,2021-11-08 02:00:00,6347.12,11.490000000045256
Sell,2,3163.11,2021-11-08 02:15:00,6326.22,6337.7100000000455
Buy,2,3163.11,2021-11-08 02:15:00,6326.22,11.490000000045256
Sell,2,3133.46,2021-11-08 02:30:00,6266.92,6278.410000000045
Buy,2,3133.46,2021-11-08 02:30:00,6266.92,11.490000000045256
Sell,2,3140.1,2021-11-08 02:45:00,6280.2,6291.690000000045
Buy,2,3140.1,2021-11-08 02:45:00,6280.2,11.490000000045256
Sell,2,3139.5,2021-11-08 03:00:00,6279.0,6290.490000000045
Buy,2,3139.5,2021-11-08 03:00:00,6279.0,11.490000000045256
Sell,2,3148.25,2021-11-08 03:15:00,6296.5,6307.990000000045
Buy,1,3168.92,2021-11-08 04:45:00,3168.92,3139.070000000045
Sell,1,3161.23,2021-11-08 05:00:00,3161.23,6300.300000000045
Buy,1,3180.57,2021-11-08 05:45:00,3180.57,3119.7300000000446
Sell,1,3179.85,2021-11-08 06:00:00,3179.85,6299.5800000000445
Buy,1,3206.06,2021-11-08 06:15:00,3206.06,3093.5200000000445
Sell,1,3176.7,2021-11-08 06:30:00,3176.7,6270.220000000045
Buy,1,3236.12,2021-11-08 07:15:00,3236.12,3034.100000000045
Sell,1,3224.12,2021-11-08 07:30:00,3224.12,6258.220000000045
Buy,1,3234.62,2021-11-08 07:45:00,3234.62,3023.600000000045
Sell,1,3221.65,2021-11-08 08:00:00,3221.65,6245.2500000000455
Buy,1,3221.65,2021-11-08 08:00:00,3221.65,3023.6000000000454
Sell,1,3222.28,2021-11-08 08:15:00,3222.28,6245.880000000046
Buy,1,3230.97,2021-11-08 10:00:00,3230.97,3014.910000000046
Sell,1,3223.85,2021-11-08 10:15:00,3223.85,6238.760000000046
Buy,1,3223.85,2021-11-08 10:15:00,3223.85,3014.910000000046
Sell,1,3226.19,2021-11-08 10:30:00,3226.19,6241.100000000046
Buy,1,3235.94,2021-11-08 11:15:00,3235.94,3005.160000000046
Sell,1,3227.57,2021-11-08 11:30:00,3227.57,6232.730000000046
Buy,1,3227.57,2021-11-08 11:30:00,3227.57,3005.160000000046
Sell,1,3216.32,2021-11-08 11:45:00,3216.32,6221.480000000046
Buy,1,3218.67,2021-11-08 12:00:00,3218.67,3002.810000000046
Sell,1,3216.25,2021-11-08 12:15:00,3216.25,6219.060000000046
Buy,1,3247.28,2021-11-08 13:15:00,3247.28,2971.7800000000457
Sell,1,3239.62,2021-11-08 13:30:00,3239.62,6211.400000000045
Buy,1,3256.91,2021-11-08 14:45:00,3256.91,2954.4900000000453
Sell,1,3259.88,2021-11-08 15:00:00,3259.88,6214.370000000045
Buy,1,3260.5,2021-11-08 15:15:00,3260.5,2953.8700000000454
Sell,1,3257.71,2021-11-08 15:30:00,3257.71,6211.580000000045
Buy,1,3257.71,2021-11-08 15:30:00,3257.71,2953.8700000000454
Sell,1,3245.99,2021-11-08 15:45:00,3245.99,6199.860000000045
Buy,1,3245.99,2021-11-08 15:45:00,3245.99,2953.8700000000454
Sell,1,3234.22,2021-11-08 16:00:00,3234.22,6188.090000000046
Buy,1,3247.0,2021-11-08 16:15:00,3247.0,2941.0900000000456
Sell,1,3242.62,2021-11-08 16:30:00,3242.62,6183.7100000000455
Buy,1,3242.62,2021-11-08 16:30:00,3242.62,2941.0900000000456
Sell,1,3238.01,2021-11-08 16:45:00,3238.01,6179.100000000046
Buy,1,3246.44,2021-11-08 17:00:00,3246.44,2932.660000000046
Sell,1,3235.0,2021-11-08 17:15:00,3235.0,6167.660000000045
Buy,1,3235.0,2021-11-08 17:15:00,3235.0,2932.6600000000453
Sell,1,3238.68,2021-11-08 17:30:00,3238.68,6171.340000000046
Buy,1,3245.96,2021-11-08 17:45:00,3245.96,2925.3800000000456
Sell,1,3236.13,2021-11-08 18:00:00,3236.13,6161.510000000046
Buy,1,3236.13,2021-11-08 18:00:00,3236.13,2925.3800000000456
Sell,1,3226.78,2021-11-08 18:15:00,3226.78,6152.160000000045
Buy,1,3234.57,2021-11-08 18:30:00,3234.57,2917.590000000045
Sell,1,3228.94,2021-11-08 18:45:00,3228.94,6146.530000000045
Buy,1,3228.94,2021-11-08 18:45:00,3228.94,2917.590000000045
Sell,1,3230.37,2021-11-08 19:00:00,3230.37,6147.960000000045
Buy,1,3263.53,2021-11-08 20:00:00,3263.53,2884.4300000000444
Sell,1,3256.49,2021-11-08 20:15:00,3256.49,6140.920000000044
Buy,1,3256.49,2021-11-08 20:15:00,3256.49,2884.430000000044
Sell,1,3253.27,2021-11-08 20:30:00,3253.27,6137.700000000044
Buy,1,3253.27,2021-11-08 20:30:00,3253.27,2884.4300000000444
Sell,1,3236.81,2021-11-08 20:45:00,3236.81,6121.240000000044
Buy,1,3236.81,2021-11-08 20:45:00,3236.81,2884.4300000000444
Sell,1,3218.97,2021-11-08 21:00:00,3218.97,6103.400000000044
Buy,1,3219.86,2021-11-08 21:15:00,3219.86,2883.540000000044
Sell,1,3227.69,2021-11-08 21:30:00,3227.69,6111.230000000044
Buy,1,3227.69,2021-11-08 21:30:00,3227.69,2883.540000000044
Sell,1,1925.49,2021-11-08 21:45:00,1925.49,4809.030000000044
Buy,1,3171.96,2021-11-08 22:45:00,3171.96,1637.0700000000443
Sell,1,3170.62,2021-11-08 23:00:00,3170.62,4807.690000000044
Buy,1,3166.08,2021-11-08 23:15:00,3166.08,1641.6100000000442
Sell,1,3173.01,2021-11-08 23:30:00,3173.01,4814.6200000000445
Buy,1,3173.01,2021-11-08 23:30:00,3173.01,1641.6100000000442
Sell,1,3161.52,2021-11-08 23:45:00,3161.52,4803.130000000045
Buy,1,3255.32,2021-11-09 00:00:00,3255.32,1547.8100000000445
Sell,1,3228.51,2021-11-09 00:15:00,3228.51,4776.320000000045
Buy,1,3244.97,2021-11-09 00:30:00,3244.97,1531.3500000000454
Sell,1,3243.18,2021-11-09 00:45:00,3243.18,4774.530000000045
Buy,1,3243.18,2021-11-09 00:45:00,3243.18,1531.3500000000454
Sell,1,3260.81,2021-11-09 01:00:00,3260.81,4792.160000000045
Buy,1,3273.83,2021-11-09 01:15:00,3273.83,1518.3300000000454
Sell,1,3286.24,2021-11-09 01:30:00,3286.24,4804.570000000045
Buy,1,3286.24,2021-11-09 01:30:00,3286.24,1518.3300000000454
Sell,1,3273.8,2021-11-09 01:45:00,3273.8,4792.130000000046
Buy,1,3290.52,2021-11-09 02:00:00,3290.52,1501.6100000000456
Sell,1,3272.38,2021-11-09 02:15:00,3272.38,4773.990000000045
Buy,1,3272.38,2021-11-09 02:15:00,3272.38,1501.6100000000451
Sell,1,3269.5,2021-11-09 02:30:00,3269.5,4771.110000000045
Buy,1,3269.22,2021-11-09 02:45:00,3269.22,1501.8900000000453
Sell,1,3241.71,2021-11-09 03:00:00,3241.71,4743.600000000046
Buy,1,3225.0,2021-11-09 03:15:00,3225.0,1518.6000000000458
Sell,1,3221.9,2021-11-09 03:30:00,3221.9,4740.5000000000455
Buy,1,3265.04,2021-11-09 04:30:00,3265.04,1475.4600000000455
Sell,1,3267.19,2021-11-09 04:45:00,3267.19,4742.650000000045
Buy,1,3267.19,2021-11-09 04:45:00,3267.19,1475.460000000045
Sell,1,3254.63,2021-11-09 05:00:00,3254.63,4730.090000000046
Buy,1,3254.63,2021-11-09 05:00:00,3254.63,1475.4600000000455
Sell,1,3234.31,2021-11-09 05:15:00,3234.31,4709.770000000046
Buy,1,3234.31,2021-11-09 05:15:00,3234.31,1475.460000000046
Sell,1,3239.16,2021-11-09 05:30:00,3239.16,4714.620000000046
Buy,1,3270.48,2021-11-09 06:00:00,3270.48,1444.1400000000463
Sell,1,3264.0,2021-11-09 06:15:00,3264.0,4708.140000000047
Buy,1,3274.47,2021-11-09 06:30:00,3274.47,1433.670000000047
Sell,1,3268.12,2021-11-09 06:45:00,3268.12,4701.790000000046
Buy,1,3268.12,2021-11-09 06:45:00,3268.12,1433.6700000000465
Sell,1,3254.55,2021-11-09 07:00:00,3254.55,4688.220000000047
Buy,1,3254.55,2021-11-09 07:00:00,3254.55,1433.6700000000465
Sell,1,3234.0,2021-11-09 07:15:00,3234.0,4667.6700000000465
Buy,1,3234.0,2021-11-09 07:15:00,3234.0,1433.6700000000465
Sell,1,3227.02,2021-11-09 07:30:00,3227.02,4660.690000000046
Buy,1,3245.0,2021-11-09 08:00:00,3245.0,1415.690000000046
Sell,1,3228.71,2021-11-09 08:15:00,3228.71,4644.400000000046
Buy,1,3255.5,2021-11-09 08:45:00,3255.5,1388.900000000046
Sell,1,3225.4,2021-11-09 09:00:00,3225.4,4614.300000000047
Buy,1,3310.01,2021-11-09 10:30:00,3310.01,1304.2900000000463
Sell,1,3309.12,2021-11-09 10:45:00,3309.12,4613.410000000046
Buy,1,3309.12,2021-11-09 10:45:00,3309.12,1304.2900000000463
Sell,1,3293.56,2021-11-09 11:00:00,3293.56,4597.850000000046
Buy,1,3293.56,2021-11-09 11:00:00,3293.56,1304.290000000046
Sell,1,3295.81,2021-11-09 11:15:00,3295.81,4600.100000000046
Buy,1,3300.36,2021-11-09 11:30:00,3300.36,1299.7400000000457
Sell,1,3293.32,2021-11-09 11:45:00,3293.32,4593.060000000046
Buy,1,3293.32,2021-11-09 11:45:00,3293.32,1299.7400000000457
Sell,1,3285.88,2021-11-09 12:00:00,3285.88,4585.620000000046
Buy,1,3333.55,2021-11-09 12:30:00,3333.55,1252.070000000046
Sell,1,3318.71,2021-11-09 12:45:00,3318.71,4570.780000000046
Buy,1,3318.71,2021-11-09 12:45:00,3318.71,1252.070000000046
Sell,1,3321.88,2021-11-09 13:00:00,3321.88,4573.950000000046
Buy,1,3321.88,2021-11-09 13:00:00,3321.88,1252.070000000046
Sell,1,3312.36,2021-11-09 13:15:00,3312.36,4564.430000000046
Buy,1,3312.36,2021-11-09 13:15:00,3312.36,1252.0700000000456
Sell,1,3315.17,2021-11-09 13:30:00,3315.17,4567.240000000045
Buy,1,3338.06,2021-11-09 14:15:00,3338.06,1229.1800000000453
Sell,1,3334.28,2021-11-09 14:30:00,3334.28,4563.4600000000455
Buy,1,3334.28,2021-11-09 14:30:00,3334.28,1229.1800000000453
Sell,1,3326.97,2021-11-09 14:45:00,3326.97,4556.150000000045
Buy,1,3326.97,2021-11-09 14:45:00,3326.97,1229.1800000000453
Sell,1,3309.58,2021-11-09 15:00:00,3309.58,4538.760000000046
Buy,1,3315.75,2021-11-09 15:15:00,3315.75,1223.0100000000457
Sell,1,3307.88,2021-11-09 15:30:00,3307.88,4530.890000000046
Buy,1,3311.53,2021-11-09 15:45:00,3311.53,1219.3600000000456
Sell,1,3295.28,2021-11-09 16:00:00,3295.28,4514.640000000046
Buy,1,3337.5,2021-11-09 16:30:00,3337.5,1177.1400000000458
Sell,1,3328.05,2021-11-09 16:45:00,3328.05,4505.190000000046
Buy,1,3328.05,2021-11-09 16:45:00,3328.05,1177.1400000000458
Sell,1,3331.82,2021-11-09 17:00:00,3331.82,4508.960000000046
Buy,1,3331.82,2021-11-09 17:00:00,3331.82,1177.1400000000463
Sell,1,3314.93,2021-11-09 17:15:00,3314.93,4492.070000000046
Buy,1,3314.93,2021-11-09 17:15:00,3314.93,1177.1400000000463
Sell,1,3317.12,2021-11-09 17:45:00,3317.12,4494.260000000046
Buy,1,3317.12,2021-11-09 17:45:00,3317.12,1177.1400000000458
Sell,1,3313.42,2021-11-09 18:00:00,3313.42,4490.560000000046
Buy,1,3313.42,2021-11-09 18:00:00,3313.42,1177.1400000000458
Sell,1,3312.85,2021-11-09 18:15:00,3312.85,4489.990000000045
Buy,1,3312.85,2021-11-09 18:15:00,3312.85,1177.1400000000453
Sell,1,3306.79,2021-11-09 18:30:00,3306.79,4483.930000000046
Buy,1,3317.56,2021-11-09 19:00:00,3317.56,1166.3700000000458
Sell,1,3294.28,2021-11-09 19:15:00,3294.28,4460.650000000046
Buy,1,3305.22,2021-11-09 19:30:00,3305.22,1155.4300000000462
Sell,1,3297.75,2021-11-09 19:45:00,3297.75,4453.180000000046
Buy,1,3297.75,2021-11-09 19:45:00,3297.75,1155.4300000000458
Sell,1,3285.85,2021-11-09 20:00:00,3285.85,4441.280000000046
Buy,1,3304.26,2021-11-09 21:15:00,3304.26,1137.020000000046
Sell,1,3290.25,2021-11-09 21:30:00,3290.25,4427.270000000046
Buy,1,3290.25,2021-11-09 21:30:00,3290.25,1137.020000000046
Sell,1,3297.57,2021-11-09 21:45:00,3297.57,4434.590000000046
Buy,1,3297.57,2021-11-09 21:45:00,3297.57,1137.0200000000455
Sell,1,3264.42,2021-11-09 22:00:00,3264.42,4401.440000000046
Buy,1,3264.42,2021-11-09 22:00:00,3264.42,1137.020000000046
Sell,1,3272.19,2021-11-09 22:15:00,3272.19,4409.210000000046
Buy,1,3279.1,2021-11-09 22:30:00,3279.1,1130.1100000000465
Sell,1,3254.61,2021-11-09 22:45:00,3254.61,4384.720000000047
Buy,1,3254.61,2021-11-09 22:45:00,3254.61,1130.1100000000465
Sell,1,3248.9,2021-11-09 23:00:00,3248.9,4379.010000000047
Buy,1,3268.91,2021-11-09 23:15:00,3268.91,1110.1000000000467
Sell,1,3254.1,2021-11-09 23:30:00,3254.1,4364.200000000046
Buy,1,3418.04,2021-11-10 00:15:00,3418.04,946.1600000000462
Sell,1,3436.17,2021-11-10 00:30:00,3436.17,4382.330000000046
Buy,1,3436.17,2021-11-10 00:30:00,3436.17,946.1600000000462
Sell,1,3444.32,2021-11-10 00:45:00,3444.32,4390.480000000047
Buy,1,3444.32,2021-11-10 00:45:00,3444.32,946.1600000000467
Sell,1,3459.08,2021-11-10 01:00:00,3459.08,4405.240000000047
Buy,1,3459.08,2021-11-10 01:00:00,3459.08,946.1600000000471
Sell,1,3470.34,2021-11-10 01:15:00,3470.34,4416.500000000047
Buy,1,3470.34,2021-11-10 01:15:00,3470.34,946.1600000000471
Sell,1,3463.6,2021-11-10 01:30:00,3463.6,4409.7600000000475
Buy,1,3463.6,2021-11-10 01:30:00,3463.6,946.1600000000476
Sell,1,3451.5,2021-11-10 01:45:00,3451.5,4397.660000000047
Buy,1,3460.03,2021-11-10 02:00:00,3460.03,937.630000000047
Sell,1,3463.43,2021-11-10 02:15:00,3463.43,4401.060000000047
Buy,1,3478.31,2021-11-10 02:45:00,3478.31,922.7500000000468
Sell,1,3467.13,2021-11-10 03:00:00,3467.13,4389.8800000000465
Buy,1,3531.7,2021-11-10 04:15:00,3531.7,858.1800000000467
Sell,1,3516.12,2021-11-10 04:30:00,3516.12,4374.300000000047
Buy,1,3521.99,2021-11-10 04:45:00,3521.99,852.3100000000468
Sell,1,3514.55,2021-11-10 05:00:00,3514.55,4366.860000000047
Buy,1,3514.55,2021-11-10 05:00:00,3514.55,852.3100000000468
Sell,1,3512.96,2021-11-10 05:15:00,3512.96,4365.270000000047
Buy,1,3518.64,2021-11-10 06:00:00,3518.64,846.630000000047
Sell,1,3515.43,2021-11-10 06:15:00,3515.43,4362.060000000047
Buy,1,3521.09,2021-11-10 06:45:00,3521.09,840.9700000000466
Sell,1,3522.73,2021-11-10 07:00:00,3522.73,4363.700000000046
Buy,1,3603.97,2021-11-10 09:00:00,3603.97,759.7300000000464
Sell,1,3601.04,2021-11-10 09:15:00,3601.04,4360.770000000046
Buy,1,3601.04,2021-11-10 09:15:00,3601.04,759.730000000046
Sell,1,3585.27,2021-11-10 09:30:00,3585.27,4345.0000000000455
Buy,1,3585.27,2021-11-10 09:30:00,3585.27,759.7300000000455
Sell,1,3583.54,2021-11-10 09:45:00,3583.54,4343.270000000046
Buy,1,3589.87,2021-11-10 10:15:00,3589.87,753.400000000046
Sell,1,3584.07,2021-11-10 10:30:00,3584.07,4337.470000000047
Buy,1,3584.07,2021-11-10 10:30:00,3584.07,753.4000000000465
Sell,1,3562.74,2021-11-10 10:45:00,3562.74,4316.140000000047
Buy,1,3562.74,2021-11-10 10:45:00,3562.74,753.4000000000469
Sell,1,3546.35,2021-11-10 11:00:00,3546.35,4299.750000000047
Buy,1,3546.35,2021-11-10 11:00:00,3546.35,753.4000000000474
Sell,1,3543.84,2021-11-10 11:15:00,3543.84,4297.240000000047
Buy,1,3593.35,2021-11-10 13:00:00,3593.35,703.8900000000472
Sell,1,3593.8,2021-11-10 13:15:00,3593.8,4297.690000000048
Buy,1,3605.12,2021-11-10 13:30:00,3605.12,692.5700000000479
Sell,1,3593.01,2021-11-10 13:45:00,3593.01,4285.580000000048
Buy,1,3593.01,2021-11-10 13:45:00,3593.01,692.5700000000479
Sell,1,3575.05,2021-11-10 14:00:00,3575.05,4267.620000000048
Buy,1,3600.44,2021-11-10 14:45:00,3600.44,667.180000000048
Sell,1,3597.48,2021-11-10 15:00:00,3597.48,4264.660000000048
Buy,1,3597.48,2021-11-10 15:00:00,3597.48,667.180000000048
Sell,1,3595.4,2021-11-10 15:15:00,3595.4,4262.580000000048
Buy,1,3601.1,2021-11-10 15:30:00,3601.1,661.4800000000482
Sell,1,3595.74,2021-11-10 15:45:00,3595.74,4257.2200000000485
Buy,1,3595.74,2021-11-10 15:45:00,3595.74,661.4800000000487
Sell,1,3595.32,2021-11-10 16:00:00,3595.32,4256.800000000048
Buy,1,3595.32,2021-11-10 16:00:00,3595.32,661.4800000000482
Sell,1,3591.5,2021-11-10 16:15:00,3591.5,4252.980000000049
Buy,1,3591.5,2021-11-10 16:15:00,3591.5,661.4800000000487
Sell,1,3588.89,2021-11-10 16:30:00,3588.89,4250.370000000048
Buy,1,3588.89,2021-11-10 16:30:00,3588.89,661.4800000000482
Sell,1,3578.87,2021-11-10 16:45:00,3578.87,4240.350000000048
Buy,1,3578.87,2021-11-10 16:45:00,3578.87,661.4800000000478
Sell,1,3581.72,2021-11-10 17:00:00,3581.72,4243.200000000048
Buy,1,3581.72,2021-11-10 17:00:00,3581.72,661.4800000000482
Sell,1,3577.48,2021-11-10 17:15:00,3577.48,4238.960000000048
Buy,1,3577.48,2021-11-10 17:15:00,3577.48,661.4800000000482
Sell,1,3576.33,2021-11-10 17:30:00,3576.33,4237.810000000049
Buy,1,3576.33,2021-11-10 17:30:00,3576.33,661.4800000000487
Sell,1,3566.35,2021-11-10 17:45:00,3566.35,4227.830000000049
Buy,1,3566.35,2021-11-10 17:45:00,3566.35,661.4800000000491
Sell,1,3556.37,2021-11-10 18:00:00,3556.37,4217.8500000000495
Buy,1,3556.37,2021-11-10 18:00:00,3556.37,661.4800000000496
Sell,1,3557.6,2021-11-10 18:15:00,3557.6,4219.080000000049
Buy,1,3557.6,2021-11-10 18:15:00,3557.6,661.4800000000491
Sell,1,3551.31,2021-11-10 18:30:00,3551.31,4212.790000000049
Buy,1,3551.31,2021-11-10 18:30:00,3551.31,661.4800000000491
Sell,1,3554.11,2021-11-10 18:45:00,3554.11,4215.590000000049
Buy,1,3572.12,2021-11-10 19:00:00,3572.12,643.4700000000494
Sell,1,3567.0,2021-11-10 19:15:00,3567.0,4210.470000000049
Buy,1,3567.0,2021-11-10 19:15:00,3567.0,643.4700000000494
Sell,1,3549.97,2021-11-10 19:30:00,3549.97,4193.44000000005
Buy,1,3549.97,2021-11-10 19:30:00,3549.97,643.4700000000498
Sell,1,3517.98,2021-11-10 19:45:00,3517.98,4161.45000000005
Buy,1,3517.98,2021-11-10 19:45:00,3517.98,643.4700000000498
Sell,1,3484.52,2021-11-10 20:00:00,3484.52,4127.99000000005
Buy,1,3508.4,2021-11-10 20:30:00,3508.4,619.5900000000497
Sell,1,3492.01,2021-11-10 20:45:00,3492.01,4111.6000000000495
Buy,1,3492.01,2021-11-10 20:45:00,3492.01,619.5900000000493
Sell,1,3482.59,2021-11-10 21:00:00,3482.59,4102.180000000049
Buy,1,3529.41,2021-11-10 22:00:00,3529.41,572.7700000000495
Sell,1,3528.34,2021-11-10 22:15:00,3528.34,4101.11000000005
Buy,1,3528.34,2021-11-10 22:15:00,3528.34,572.7700000000495
Sell,1,3524.49,2021-11-10 22:30:00,3524.49,4097.260000000049
Buy,1,3524.49,2021-11-10 22:30:00,3524.49,572.7700000000495
Sell,1,3513.71,2021-11-10 22:45:00,3513.71,4086.4800000000496
Buy,1,3513.71,2021-11-10 22:45:00,3513.71,572.7700000000495
Sell,1,3510.38,2021-11-10 23:00:00,3510.38,4083.1500000000497
Buy,1,3518.68,2021-11-10 23:15:00,3518.68,564.4700000000498
Sell,1,3514.22,2021-11-10 23:30:00,3514.22,4078.6900000000496
Buy,1,3543.1,2021-11-10 23:45:00,3543.1,535.5900000000497
Sell,1,4605.32,2021-11-11 00:00:00,4605.32,5140.910000000049
Buy,1,4605.32,2021-11-11 00:00:00,4605.32,535.5900000000493
Sell,1,4608.05,2021-11-11 00:15:00,4608.05,5143.640000000049
Buy,1,4608.05,2021-11-11 00:15:00,4608.05,535.5900000000493
Sell,1,4592.35,2021-11-11 00:30:00,4592.35,5127.94000000005
Buy,1,4592.35,2021-11-11 00:30:00,4592.35,535.5900000000493
Sell,1,4630.84,2021-11-11 00:45:00,4630.84,5166.430000000049
Buy,1,4630.84,2021-11-11 00:45:00,4630.84,535.5900000000493
Sell,1,4617.35,2021-11-11 01:00:00,4617.35,5152.94000000005
Buy,1,4617.35,2021-11-11 01:00:00,4617.35,535.5900000000493
Sell,1,4605.34,2021-11-11 01:15:00,4605.34,5140.930000000049
Buy,1,4605.34,2021-11-11 01:15:00,4605.34,535.5900000000493
Sell,1,4609.05,2021-11-11 01:30:00,4609.05,5144.640000000049
Buy,1,4609.05,2021-11-11 01:30:00,4609.05,535.5900000000493
Sell,1,4620.24,2021-11-11 01:45:00,4620.24,5155.830000000049
Buy,1,4620.24,2021-11-11 01:45:00,4620.24,535.5900000000493
Sell,1,4590.15,2021-11-11 02:00:00,4590.15,5125.740000000049
Buy,1,4590.15,2021-11-11 02:00:00,4590.15,535.5900000000493
Sell,1,4590.61,2021-11-11 02:15:00,4590.61,5126.200000000049
Buy,1,4590.61,2021-11-11 02:15:00,4590.61,535.5900000000493
Sell,1,4596.53,2021-11-11 02:30:00,4596.53,5132.120000000049
Buy,1,4596.53,2021-11-11 02:30:00,4596.53,535.5900000000493
Sell,1,4618.63,2021-11-11 02:45:00,4618.63,5154.220000000049
Buy,1,4641.14,2021-11-11 03:15:00,4641.14,513.080000000049
Sell,1,4631.85,2021-11-11 03:30:00,4631.85,5144.930000000049
Buy,1,4631.85,2021-11-11 03:30:00,4631.85,513.080000000049
Sell,1,4640.24,2021-11-11 03:45:00,4640.24,5153.320000000049
Buy,1,4634.56,2021-11-11 04:00:00,4634.56,518.7600000000484
Sell,1,4632.39,2021-11-11 04:15:00,4632.39,5151.150000000049
Buy,1,4660.0,2021-11-11 05:15:00,4660.0,491.15000000004875
Sell,1,4647.89,2021-11-11 05:30:00,4647.89,5139.040000000049
Buy,1,4660.19,2021-11-11 06:00:00,4660.19,478.8500000000495
Sell,1,4656.37,2021-11-11 06:15:00,4656.37,5135.220000000049
Buy,1,4679.35,2021-11-11 07:00:00,4679.35,455.870000000049
Sell,1,4682.96,2021-11-11 07:15:00,4682.96,5138.830000000049
Buy,1,4693.68,2021-11-11 07:45:00,4693.68,445.15000000004875
Sell,1,4674.47,2021-11-11 08:00:00,4674.47,5119.620000000049
Buy,1,4674.47,2021-11-11 08:00:00,4674.47,445.15000000004875
Sell,1,4661.68,2021-11-11 08:15:00,4661.68,5106.830000000049
Buy,1,4674.01,2021-11-11 08:30:00,4674.01,432.8200000000488
Sell,1,4723.31,2021-11-11 08:45:00,4723.31,5156.130000000049
Buy,1,4723.31,2021-11-11 08:45:00,4723.31,432.8200000000488
Sell,1,4715.29,2021-11-11 09:00:00,4715.29,5148.110000000049
Buy,1,4744.9,2021-11-11 09:15:00,4744.9,403.21000000004915
Sell,1,4728.78,2021-11-11 09:30:00,4728.78,5131.990000000049
Buy,1,4728.78,2021-11-11 09:30:00,4728.78,403.21000000004915
Sell,1,4731.89,2021-11-11 09:45:00,4731.89,5135.1000000000495
Buy,1,4720.64,2021-11-11 10:00:00,4720.64,414.46000000004915
Sell,1,4710.49,2021-11-11 10:15:00,4710.49,5124.950000000049
Buy,1,4719.93,2021-11-11 10:30:00,4719.93,405.02000000004864
Sell,1,4710.32,2021-11-11 10:45:00,4710.32,5115.340000000048
Buy,1,4710.32,2021-11-11 10:45:00,4710.32,405.02000000004864
Sell,1,4710.42,2021-11-11 11:00:00,4710.42,5115.440000000049
Buy,1,4715.76,2021-11-11 11:15:00,4715.76,399.6800000000485
Sell,1,4699.19,2021-11-11 11:30:00,4699.19,5098.870000000048
Buy,1,4724.25,2021-11-11 11:45:00,4724.25,374.6200000000481
Sell,1,4688.98,2021-11-11 12:00:00,4688.98,5063.600000000048
Buy,1,4688.98,2021-11-11 12:00:00,4688.98,374.6200000000481
Sell,1,4694.04,2021-11-11 12:15:00,4694.04,5068.660000000048
Buy,1,4718.05,2021-11-11 12:45:00,4718.05,350.6100000000479
Sell,1,4700.05,2021-11-11 13:00:00,4700.05,5050.660000000048
Buy,1,4715.74,2021-11-11 13:30:00,4715.74,334.9200000000483
Sell,1,4705.9,2021-11-11 13:45:00,4705.9,5040.820000000048
Buy,1,4705.9,2021-11-11 13:45:00,4705.9,334.9200000000483
Sell,1,4686.18,2021-11-11 14:00:00,4686.18,5021.100000000049
Buy,1,4686.18,2021-11-11 14:00:00,4686.18,334.9200000000483
Sell,1,4696.05,2021-11-11 14:15:00,4696.05,5030.9700000000485
Buy,1,4696.05,2021-11-11 14:15:00,4696.05,334.9200000000483
Sell,1,4747.02,2021-11-11 14:30:00,4747.02,5081.940000000049
Buy,1,4747.02,2021-11-11 14:30:00,4747.02,334.9200000000483
Sell,1,4738.78,2021-11-11 14:45:00,4738.78,5073.700000000048
Buy,1,4758.38,2021-11-11 15:00:00,4758.38,315.3200000000479
Sell,1,4725.0,2021-11-11 15:15:00,4725.0,5040.320000000048
Buy,1,4725.0,2021-11-11 15:15:00,4725.0,315.3200000000479
Sell,1,4725.99,2021-11-11 15:30:00,4725.99,5041.310000000048
Buy,1,4725.99,2021-11-11 15:30:00,4725.99,315.3200000000479
Sell,1,4722.06,2021-11-11 15:45:00,4722.06,5037.380000000048
Buy,1,4722.06,2021-11-11 15:45:00,4722.06,315.3200000000479
Sell,1,4735.75,2021-11-11 16:00:00,4735.75,5051.070000000048
Buy,1,4769.41,2021-11-11 16:45:00,4769.41,281.66000000004806
Sell,1,4762.25,2021-11-11 17:00:00,4762.25,5043.910000000048
Buy,1,4762.25,2021-11-11 17:00:00,4762.25,281.66000000004806
Sell,1,4750.82,2021-11-11 17:15:00,4750.82,5032.480000000048
Buy,1,4762.82,2021-11-11 17:30:00,4762.82,269.66000000004806
Sell,1,4752.82,2021-11-11 17:45:00,4752.82,5022.480000000048
Buy,1,4752.82,2021-11-11 17:45:00,4752.82,269.66000000004806
Sell,1,4755.61,2021-11-11 18:00:00,4755.61,5025.270000000048
Buy,1,4755.61,2021-11-11 18:00:00,4755.61,269.66000000004806
Sell,1,4736.86,2021-11-11 18:15:00,4736.86,5006.520000000048
Buy,1,4736.86,2021-11-11 18:15:00,4736.86,269.66000000004806
Sell,1,4722.51,2021-11-11 18:30:00,4722.51,4992.170000000048
Buy,1,4751.35,2021-11-11 19:15:00,4751.35,240.8200000000479
Sell,1,4751.08,2021-11-11 19:30:00,4751.08,4991.900000000048
Buy,1,4764.08,2021-11-11 20:00:00,4764.08,227.8200000000479
Sell,1,4747.54,2021-11-11 20:15:00,4747.54,4975.360000000048
Buy,1,4747.54,2021-11-11 20:15:00,4747.54,227.8200000000479
Sell,1,4741.25,2021-11-11 20:30:00,4741.25,4969.070000000048
Buy,1,4741.25,2021-11-11 20:30:00,4741.25,227.8200000000479
Sell,1,4733.34,2021-11-11 20:45:00,4733.34,4961.160000000048
Buy,1,4744.24,2021-11-11 21:15:00,4744.24,216.92000000004828
Sell,1,4738.5,2021-11-11 21:30:00,4738.5,4955.420000000048
Buy,1,4745.52,2021-11-11 21:45:00,4745.52,209.90000000004784
Sell,1,4742.78,2021-11-11 22:00:00,4742.78,4952.680000000048
Buy,1,4742.78,2021-11-11 22:00:00,4742.78,209.90000000004784
Sell,1,4752.3,2021-11-11 22:15:00,4752.3,4962.200000000048
Buy,1,4752.3,2021-11-11 22:15:00,4752.3,209.90000000004784
Sell,1,4748.24,2021-11-11 22:30:00,4748.24,4958.140000000048
Buy,1,4748.24,2021-11-11 22:30:00,4748.24,209.90000000004784
Sell,1,4752.65,2021-11-11 22:45:00,4752.65,4962.5500000000475
Buy,1,4752.65,2021-11-11 22:45:00,4752.65,209.90000000004784
Sell,1,4741.67,2021-11-11 23:00:00,4741.67,4951.570000000048
Buy,1,4741.67,2021-11-11 23:00:00,4741.67,209.90000000004784
Sell,1,4734.73,2021-11-11 23:15:00,4734.73,4944.630000000047
Buy,1,4734.73,2021-11-11 23:15:00,4734.73,209.90000000004784
Sell,1,4718.25,2021-11-11 23:30:00,4718.25,4928.150000000048
Buy,1,4721.19,2021-11-11 23:45:00,4721.19,206.96000000004824
Sell,1,3859.12,2021-11-12 00:00:00,3859.12,4066.080000000048
Buy,1,3985.0,2021-11-12 02:30:00,3985.0,81.08000000004813
Sell,1,3988.18,2021-11-12 02:45:00,3988.18,4069.260000000048
Buy,1,3988.18,2021-11-12 02:45:00,3988.18,81.08000000004813
Sell,1,4010.99,2021-11-12 03:00:00,4010.99,4092.070000000048
Buy,1,4018.18,2021-11-12 03:15:00,4018.18,73.89000000004808
Sell,1,4012.69,2021-11-12 03:30:00,4012.69,4086.580000000048
Buy,1,4012.69,2021-11-12 03:30:00,4012.69,73.89000000004808
Sell,1,4007.43,2021-11-12 03:45:00,4007.43,4081.320000000048
Buy,1,4033.98,2021-11-12 04:00:00,4033.98,47.340000000047894
Sell,1,4022.66,2021-11-12 04:15:00,4022.66,4070.0000000000477
Buy,1,4031.01,2021-11-12 04:45:00,4031.01,38.99000000004753
Sell,1,4024.64,2021-11-12 05:00:00,4024.64,4063.6300000000474
Buy,1,4035.9,2021-11-12 05:30:00,4035.9,27.730000000047312
Sell,1,4029.08,2021-11-12 05:45:00,4029.08,4056.8100000000472
Buy,1,4048.51,2021-11-12 06:00:00,4048.51,8.30000000004702
Sell,1,4006.45,2021-11-12 06:15:00,4006.45,4014.750000000047
Buy,1,4006.45,2021-11-12 06:15:00,4006.45,8.30000000004702
Sell,1,3998.98,2021-11-12 06:30:00,3998.98,4007.280000000047
Buy,1,3998.98,2021-11-12 06:30:00,3998.98,8.30000000004702
Sell,1,3960.72,2021-11-12 06:45:00,3960.72,3969.020000000047
Buy,1,3967.5,2021-11-12 07:15:00,3967.5,1.5200000000468208
Sell,1,3970.61,2021-11-12 07:30:00,3970.61,3972.130000000047
Buy,1,2613.15,2021-12-06 02:15:00,2613.15,1358.9800000000469
Sell,1,2287.07,2021-12-06 02:30:00,2287.07,3646.050000000047
Buy,1,2297.41,2021-12-06 03:15:00,2297.41,1348.6400000000472
Sell,1,2284.94,2021-12-06 03:30:00,2284.94,3633.580000000047
Buy,1,2613.15,2021-12-06 04:00:00,2613.15,1020.4300000000471
Sell,1,2294.86,2021-12-06 04:15:00,2294.86,3315.2900000000473
Buy,1,2294.86,2021-12-06 04:15:00,2294.86,1020.4300000000471
Sell,1,2283.25,2021-12-06 04:30:00,2283.25,3303.680000000047
Buy,1,2283.72,2021-12-06 04:45:00,2283.72,1019.9600000000473
Sell,1,2294.23,2021-12-06 05:00:00,2294.23,3314.1900000000473
Buy,1,2294.23,2021-12-06 05:00:00,2294.23,1019.9600000000473
Sell,1,2288.52,2021-12-06 05:30:00,2288.52,3308.4800000000473
Buy,1,2288.52,2021-12-06 05:30:00,2288.52,1019.9600000000473
Sell,1,2289.74,2021-12-06 05:45:00,2289.74,3309.700000000047
Buy,1,2289.74,2021-12-06 05:45:00,2289.74,1019.9600000000473
Sell,1,2297.83,2021-12-06 06:00:00,2297.83,3317.7900000000473
Buy,1,2316.08,2021-12-06 07:00:00,2316.08,1001.7100000000473
Sell,1,2311.36,2021-12-06 07:15:00,2311.36,3313.0700000000475
Buy,1,2320.72,2021-12-06 07:45:00,2320.72,992.3500000000477
Sell,1,2320.68,2021-12-06 08:00:00,2320.68,3313.0300000000475
Buy,1,2320.68,2021-12-06 08:00:00,2320.68,992.3500000000477
Sell,1,2312.12,2021-12-06 08:15:00,2312.12,3304.4700000000475
Buy,1,2312.12,2021-12-06 08:15:00,2312.12,992.3500000000477
Sell,1,2313.08,2021-12-06 08:30:00,2313.08,3305.4300000000476
Buy,1,2313.08,2021-12-06 08:30:00,2313.08,992.3500000000477
Sell,1,2307.54,2021-12-06 08:45:00,2307.54,3299.8900000000476
Buy,1,2322.42,2021-12-06 09:15:00,2322.42,977.4700000000475
Sell,1,2320.17,2021-12-06 09:30:00,2320.17,3297.6400000000476
Buy,1,2325.02,2021-12-06 09:45:00,2325.02,972.6200000000476
Sell,1,2308.68,2021-12-06 10:00:00,2308.68,3281.3000000000475
Buy,1,2392.05,2021-12-06 10:45:00,2392.05,889.2500000000473
Sell,1,2372.17,2021-12-06 11:15:00,2372.17,3261.4200000000474
Buy,1,2372.17,2021-12-06 11:15:00,2372.17,889.2500000000473
Sell,1,2375.38,2021-12-06 11:30:00,2375.38,3264.6300000000474
Buy,1,2419.5,2021-12-06 12:15:00,2419.5,845.1300000000474
Sell,1,2437.59,2021-12-06 12:30:00,2437.59,3282.7200000000475
Buy,1,2437.59,2021-12-06 12:30:00,2437.59,845.1300000000474
Sell,1,2437.41,2021-12-06 12:45:00,2437.41,3282.5400000000473
Buy,1,2437.41,2021-12-06 12:45:00,2437.41,845.1300000000474
Sell,1,2429.32,2021-12-06 13:00:00,2429.32,3274.4500000000476
Buy,1,2613.15,2021-12-06 13:30:00,2613.15,661.3000000000475
Sell,1,2433.76,2021-12-06 13:45:00,2433.76,3095.0600000000477
Buy,1,2433.76,2021-12-06 13:45:00,2433.76,661.3000000000475
Sell,1,2420.7,2021-12-06 14:00:00,2420.7,3082.0000000000473
Buy,1,2417.0,2021-12-06 14:15:00,2417.0,665.0000000000473
Sell,1,2414.0,2021-12-06 14:30:00,2414.0,3079.0000000000473
Buy,1,2414.0,2021-12-06 14:30:00,2414.0,665.0000000000473
Sell,1,2420.08,2021-12-06 14:45:00,2420.08,3085.080000000047
Buy,1,2420.08,2021-12-06 14:45:00,2420.08,665.0000000000473
Sell,1,2416.38,2021-12-06 15:00:00,2416.38,3081.3800000000474
Buy,1,2416.38,2021-12-06 15:00:00,2416.38,665.0000000000473
Sell,1,2404.87,2021-12-06 15:15:00,2404.87,3069.870000000047
Buy,1,2613.15,2021-12-06 15:30:00,2613.15,456.7200000000471
Sell,1,2392.49,2021-12-06 15:45:00,2392.49,2849.210000000047
Buy,1,2391.5,2021-12-06 16:15:00,2391.5,457.7100000000469
Sell,1,2390.76,2021-12-06 16:45:00,2390.76,2848.470000000047
Buy,1,2390.76,2021-12-06 16:45:00,2390.76,457.7100000000469
Sell,1,2395.91,2021-12-06 17:00:00,2395.91,2853.6200000000467
Buy,1,2395.91,2021-12-06 17:00:00,2395.91,457.7100000000469
Sell,1,2391.03,2021-12-06 17:15:00,2391.03,2848.740000000047
Buy,1,2411.24,2021-12-06 17:45:00,2411.24,437.5000000000473
Sell,1,2415.9,2021-12-06 18:00:00,2415.9,2853.4000000000474
Buy,1,2413.34,2021-12-06 18:15:00,2413.34,440.06000000004724
Sell,1,2420.41,2021-12-06 18:30:00,2420.41,2860.470000000047
Buy,1,2421.01,2021-12-06 19:00:00,2421.01,439.4600000000469
Sell,1,2417.72,2021-12-06 19:15:00,2417.72,2857.1800000000467
Buy,1,2417.72,2021-12-06 19:15:00,2417.72,439.4600000000469
Sell,1,2414.2,2021-12-06 19:30:00,2414.2,2853.6600000000467
Buy,1,2414.2,2021-12-06 19:30:00,2414.2,439.4600000000469
Sell,1,2409.78,2021-12-06 19:45:00,2409.78,2849.240000000047
Buy,1,2409.78,2021-12-06 19:45:00,2409.78,439.4600000000469
Sell,1,2414.86,2021-12-06 20:00:00,2414.86,2854.320000000047
Buy,1,2409.99,2021-12-06 20:15:00,2409.99,444.3300000000472
Sell,1,2405.47,2021-12-06 20:30:00,2405.47,2849.800000000047
Buy,1,2405.47,2021-12-06 20:30:00,2405.47,444.3300000000472
Sell,1,2403.52,2021-12-06 20:45:00,2403.52,2847.850000000047
Buy,1,2409.99,2021-12-06 21:15:00,2409.99,437.8600000000474
Sell,1,2400.61,2021-12-06 21:30:00,2400.61,2838.4700000000475
Buy,1,2613.15,2021-12-06 22:15:00,2613.15,225.32000000004746
Sell,1,2380.14,2021-12-06 22:30:00,2380.14,2605.4600000000473
Buy,1,2380.14,2021-12-06 22:30:00,2380.14,225.32000000004746
Sell,1,2380.67,2021-12-06 22:45:00,2380.67,2605.9900000000475
Buy,1,2392.43,2021-12-06 23:00:00,2392.43,213.5600000000477
Sell,1,2390.95,2021-12-06 23:15:00,2390.95,2604.5100000000475
Buy,1,2390.95,2021-12-06 23:15:00,2390.95,213.5600000000477
Sell,1,2385.71,2021-12-06 23:30:00,2385.71,2599.2700000000477
Buy,1,2370.59,2021-12-06 23:45:00,2370.59,228.68000000004758
Sell,1,2129.38,2021-12-07 00:00:00,2129.38,2358.0600000000477
Buy,1,2146.83,2021-12-07 02:15:00,2146.83,211.23000000004777
Sell,1,2146.13,2021-12-07 02:30:00,2146.13,2357.360000000048
Buy,1,2162.24,2021-12-07 03:15:00,2162.24,195.1200000000481
Sell,1,2162.46,2021-12-07 03:30:00,2162.46,2357.580000000048
Buy,1,2165.22,2021-12-07 04:00:00,2165.22,192.36000000004833
Sell,1,2155.3,2021-12-07 04:15:00,2155.3,2347.6600000000485
Buy,1,2155.3,2021-12-07 04:15:00,2155.3,192.36000000004833
Sell,1,2148.25,2021-12-07 04:30:00,2148.25,2340.6100000000483
Buy,1,2148.19,2021-12-07 04:45:00,2148.19,192.42000000004828
Sell,1,2141.2,2021-12-07 05:00:00,2141.2,2333.620000000048
Buy,1,2141.2,2021-12-07 05:00:00,2141.2,192.42000000004828
Sell,1,2141.41,2021-12-07 05:15:00,2141.41,2333.830000000048
Buy,1,2150.0,2021-12-07 05:45:00,2150.0,183.83000000004813
Sell,1,2145.33,2021-12-07 06:00:00,2145.33,2329.160000000048
Buy,1,2157.16,2021-12-07 07:15:00,2157.16,172.0000000000482
Sell,1,2151.56,2021-12-07 07:30:00,2151.56,2323.560000000048
Buy,1,2151.56,2021-12-07 07:30:00,2151.56,172.0000000000482
Sell,1,2145.73,2021-12-07 07:45:00,2145.73,2317.730000000048
Buy,1,2150.05,2021-12-07 08:00:00,2150.05,167.68000000004804
Sell,1,2145.61,2021-12-07 08:15:00,2145.61,2313.290000000048
Buy,1,2145.61,2021-12-07 08:15:00,2145.61,167.68000000004804
Sell,1,2145.86,2021-12-07 08:30:00,2145.86,2313.540000000048
Buy,1,2145.86,2021-12-07 08:30:00,2145.86,167.68000000004804
Sell,1,2143.27,2021-12-07 08:45:00,2143.27,2310.950000000048
Buy,1,2143.27,2021-12-07 08:45:00,2143.27,167.68000000004804
Sell,1,2141.57,2021-12-07 09:00:00,2141.57,2309.250000000048
Buy,1,2141.57,2021-12-07 09:00:00,2141.57,167.68000000004804
Sell,1,2135.47,2021-12-07 09:15:00,2135.47,2303.150000000048
Buy,1,2135.47,2021-12-07 09:15:00,2135.47,167.68000000004804
Sell,1,2138.75,2021-12-07 09:30:00,2138.75,2306.430000000048
Buy,1,2138.75,2021-12-07 09:30:00,2138.75,167.68000000004804
Sell,1,2131.82,2021-12-07 09:45:00,2131.82,2299.500000000048
Buy,1,2131.82,2021-12-07 09:45:00,2131.82,167.68000000004804
Sell,1,2118.64,2021-12-07 10:00:00,2118.64,2286.320000000048
Buy,1,2117.37,2021-12-07 10:15:00,2117.37,168.95000000004802
Sell,1,2108.19,2021-12-07 10:30:00,2108.19,2277.140000000048
Buy,1,2110.75,2021-12-07 10:45:00,2110.75,166.39000000004808
Sell,1,2107.86,2021-12-07 11:00:00,2107.86,2274.250000000048
Buy,1,2107.86,2021-12-07 11:00:00,2107.86,166.39000000004808
Sell,1,2107.51,2021-12-07 11:15:00,2107.51,2273.9000000000483
Buy,1,2108.72,2021-12-07 11:30:00,2108.72,165.1800000000485
Sell,1,2100.79,2021-12-07 11:45:00,2100.79,2265.9700000000485
Buy,1,2107.0,2021-12-07 12:00:00,2107.0,158.97000000004846
Sell,1,2100.31,2021-12-07 12:15:00,2100.31,2259.2800000000484
Buy,1,2100.31,2021-12-07 12:15:00,2100.31,158.97000000004846
Sell,1,2103.1,2021-12-07 12:30:00,2103.1,2262.0700000000484
Buy,1,2109.04,2021-12-07 12:45:00,2109.04,153.0300000000484
Sell,1,2104.3,2021-12-07 13:00:00,2104.3,2257.3300000000486
Buy,1,2104.3,2021-12-07 13:00:00,2104.3,153.0300000000484
Sell,1,2100.13,2021-12-07 13:15:00,2100.13,2253.1600000000485
Buy,1,2100.13,2021-12-07 13:15:00,2100.13,153.0300000000484
Sell,1,2097.51,2021-12-07 13:30:00,2097.51,2250.5400000000486
Buy,1,2106.27,2021-12-07 13:45:00,2106.27,144.27000000004864
Sell,1,2101.1,2021-12-07 14:00:00,2101.1,2245.3700000000485
Buy,1,2101.1,2021-12-07 14:00:00,2101.1,144.27000000004864
Sell,1,2097.0,2021-12-07 14:15:00,2097.0,2241.2700000000486
Buy,1,2099.16,2021-12-07 14:30:00,2099.16,142.11000000004879
Sell,1,2097.09,2021-12-07 14:45:00,2097.09,2239.200000000049
Buy,1,2097.09,2021-12-07 14:45:00,2097.09,142.11000000004879
Sell,1,2094.49,2021-12-07 15:00:00,2094.49,2236.6000000000486
Buy,1,2094.49,2021-12-07 15:00:00,2094.49,142.11000000004879
Sell,1,2095.95,2021-12-07 15:15:00,2095.95,2238.0600000000486
Buy,1,2095.95,2021-12-07 15:15:00,2095.95,142.11000000004879
Sell,1,2091.48,2021-12-07 15:30:00,2091.48,2233.590000000049
Buy,1,2091.48,2021-12-07 15:30:00,2091.48,142.11000000004879
Sell,1,2086.8,2021-12-07 15:45:00,2086.8,2228.910000000049
Buy,1,2086.8,2021-12-07 15:45:00,2086.8,142.11000000004879
Sell,1,2063.85,2021-12-07 16:00:00,2063.85,2205.9600000000487
Buy,1,2063.85,2021-12-07 16:00:00,2063.85,142.11000000004879
Sell,1,2059.93,2021-12-07 16:15:00,2059.93,2202.0400000000486
Buy,1,2059.93,2021-12-07 16:15:00,2059.93,142.11000000004879
Sell,1,2043.0,2021-12-07 16:30:00,2043.0,2185.110000000049
Buy,1,2043.0,2021-12-07 16:30:00,2043.0,142.11000000004879
Sell,1,2049.09,2021-12-07 16:45:00,2049.09,2191.200000000049
Buy,1,2049.09,2021-12-07 16:45:00,2049.09,142.11000000004879
Sell,1,2045.78,2021-12-07 17:00:00,2045.78,2187.8900000000485
Buy,1,2045.78,2021-12-07 17:00:00,2045.78,142.11000000004856
Sell,1,2047.73,2021-12-07 17:15:00,2047.73,2189.8400000000483
Buy,1,2047.73,2021-12-07 17:15:00,2047.73,142.11000000004833
Sell,1,2039.0,2021-12-07 17:30:00,2039.0,2181.1100000000483
Buy,1,2039.0,2021-12-07 17:30:00,2039.0,142.11000000004833
Sell,1,2030.32,2021-12-07 17:45:00,2030.32,2172.4300000000485
Buy,1,2030.32,2021-12-07 17:45:00,2030.32,142.11000000004856
Sell,1,2027.16,2021-12-07 18:00:00,2027.16,2169.2700000000486
Buy,1,2029.56,2021-12-07 18:15:00,2029.56,139.7100000000487
Sell,1,2030.11,2021-12-07 18:30:00,2030.11,2169.820000000049
Buy,1,2030.11,2021-12-07 18:30:00,2030.11,139.71000000004892
Sell,1,2023.23,2021-12-07 18:45:00,2023.23,2162.9400000000487
Buy,1,2036.33,2021-12-07 19:00:00,2036.33,126.61000000004879
Sell,1,2022.41,2021-12-07 19:15:00,2022.41,2149.0200000000486
Buy,1,2022.41,2021-12-07 19:15:00,2022.41,126.61000000004856
Sell,1,2015.07,2021-12-07 19:30:00,2015.07,2141.6800000000485
Buy,1,2029.5,2021-12-07 20:30:00,2029.5,112.1800000000485
Sell,1,2025.73,2021-12-07 20:45:00,2025.73,2137.9100000000485
Buy,1,2030.96,2021-12-07 21:15:00,2030.96,106.95000000004848
Sell,1,2026.58,2021-12-07 21:30:00,2026.58,2133.5300000000484
Buy,1,2038.86,2021-12-07 22:15:00,2038.86,94.6700000000485
Sell,1,2035.79,2021-12-07 22:30:00,2035.79,2130.4600000000482
Buy,1,2036.5,2021-12-07 22:45:00,2036.5,93.96000000004824
Sell,1,2031.29,2021-12-07 23:00:00,2031.29,2125.250000000048
Buy,1,2031.29,2021-12-07 23:00:00,2031.29,93.96000000004824
Sell,1,2029.99,2021-12-07 23:15:00,2029.99,2123.950000000048
Buy,1,2029.99,2021-12-07 23:15:00,2029.99,93.96000000004801
Sell,1,2031.56,2021-12-07 23:30:00,2031.56,2125.5200000000477
