Action,Quantity,Price,Time,Portfolio Value,Remaining Balance
Buy,210,4750.45,2021-10-11 00:00:00,997594.5,2405.5
Sell,210,4754.49,2021-10-11 00:15:00,998442.8999999999,1000848.3999999999
Buy,210,4754.49,2021-10-11 00:15:00,998442.8999999999,2405.5
Sell,210,4722.65,2021-10-11 00:30:00,991756.4999999999,994161.9999999999
Buy,210,4722.65,2021-10-11 00:30:00,991756.4999999999,2405.5
Sell,210,4724.01,2021-10-11 00:45:00,992042.1000000001,994447.6000000001
Buy,210,4724.01,2021-10-11 00:45:00,992042.1000000001,2405.5
Sell,210,4738.12,2021-10-11 01:00:00,995005.2,997410.7
Buy,210,4738.12,2021-10-11 01:00:00,995005.2,2405.5
Sell,210,4744.99,2021-10-11 01:15:00,996447.8999999999,998853.3999999999
Buy,210,4744.99,2021-10-11 01:15:00,996447.8999999999,2405.5
Sell,210,4744.15,2021-10-11 01:30:00,996271.4999999999,998676.9999999999
Buy,210,4744.15,2021-10-11 01:30:00,996271.4999999999,2405.5
Sell,210,4733.59,2021-10-11 01:45:00,994053.9,996459.4
Buy,210,4733.59,2021-10-11 01:45:00,994053.9,2405.5
Sell,210,4746.99,2021-10-11 02:00:00,996867.8999999999,999273.3999999999
Buy,210,4746.99,2021-10-11 02:00:00,996867.8999999999,2405.5
Sell,210,4750.79,2021-10-11 02:15:00,997665.9,1000071.4
Buy,210,4750.79,2021-10-11 02:15:00,997665.9,2405.5
Sell,210,4733.94,2021-10-11 02:30:00,994127.3999999999,996532.8999999999
Buy,210,4733.94,2021-10-11 02:30:00,994127.3999999999,2405.5
Sell,210,4740.82,2021-10-11 02:45:00,995572.2,997977.7
Buy,210,4740.82,2021-10-11 02:45:00,995572.2,2405.5
Sell,210,4722.29,2021-10-11 03:00:00,991680.9,994086.4
Buy,210,4722.29,2021-10-11 03:00:00,991680.9,2405.5
Sell,210,4695.63,2021-10-11 03:15:00,986082.3,988487.8
Buy,210,4695.63,2021-10-11 03:15:00,986082.3,2405.5
Sell,210,4684.89,2021-10-11 03:30:00,983826.9,986232.4
Buy,210,4684.89,2021-10-11 03:30:00,983826.9,2405.5
Sell,210,4695.28,2021-10-11 03:45:00,986008.7999999999,988414.2999999999
Buy,210,4695.28,2021-10-11 03:45:00,986008.7999999999,2405.5
Sell,210,4683.13,2021-10-11 04:00:00,983457.3,985862.8
Buy,210,4683.13,2021-10-11 04:00:00,983457.3,2405.5
Sell,210,4699.21,2021-10-11 04:15:00,986834.1,989239.6
Buy,210,4699.21,2021-10-11 04:15:00,986834.1,2405.5
Sell,210,4713.35,2021-10-11 04:30:00,989803.5000000001,992209.0000000001
Buy,210,4713.35,2021-10-11 04:30:00,989803.5000000001,2405.5
Sell,210,4716.31,2021-10-11 04:45:00,990425.1000000001,992830.6000000001
Buy,210,4716.31,2021-10-11 04:45:00,990425.1000000001,2405.5
Sell,210,4701.55,2021-10-11 05:00:00,987325.5,989731.0
Buy,210,4701.55,2021-10-11 05:00:00,987325.5,2405.5
Sell,210,4717.64,2021-10-11 05:15:00,990704.4,993109.9
Buy,210,4717.64,2021-10-11 05:15:00,990704.4,2405.5
Sell,210,4706.72,2021-10-11 05:30:00,988411.2000000001,990816.7000000001
Buy,210,4706.72,2021-10-11 05:30:00,988411.2000000001,2405.5
Sell,210,4703.17,2021-10-11 05:45:00,987665.7000000001,990071.2000000001
Buy,210,4703.17,2021-10-11 05:45:00,987665.7000000001,2405.5
Sell,210,4717.87,2021-10-11 06:00:00,990752.7,993158.2
Buy,210,4717.87,2021-10-11 06:00:00,990752.7,2405.5
Sell,210,4706.15,2021-10-11 06:15:00,988291.4999999999,990696.9999999999
Buy,210,4706.15,2021-10-11 06:15:00,988291.4999999999,2405.5
Sell,210,4715.69,2021-10-11 06:30:00,990294.8999999999,992700.3999999999
Buy,210,4715.69,2021-10-11 06:30:00,990294.8999999999,2405.5
Sell,210,4742.92,2021-10-11 06:45:00,996013.2000000001,998418.7000000001
Buy,210,4742.92,2021-10-11 06:45:00,996013.2000000001,2405.5
Sell,210,4731.09,2021-10-11 07:00:00,993528.9,995934.4
Buy,210,4731.09,2021-10-11 07:00:00,993528.9,2405.5
Sell,210,4741.95,2021-10-11 07:15:00,995809.5,998215.0
Buy,210,4741.95,2021-10-11 07:15:00,995809.5,2405.5
Sell,210,4720.9,2021-10-11 07:30:00,991388.9999999999,993794.4999999999
Buy,210,4720.9,2021-10-11 07:30:00,991388.9999999999,2405.5
Sell,210,4718.79,2021-10-11 07:45:00,990945.9,993351.4
Buy,210,4718.79,2021-10-11 07:45:00,990945.9,2405.5
Sell,210,4723.42,2021-10-11 08:00:00,991918.2000000001,994323.7000000001
Buy,210,4723.42,2021-10-11 08:00:00,991918.2000000001,2405.5
Sell,210,4730.12,2021-10-11 08:15:00,993325.2,995730.7
Buy,210,4730.12,2021-10-11 08:15:00,993325.2,2405.5
Sell,210,4719.07,2021-10-11 08:30:00,991004.7,993410.2
Buy,210,4719.07,2021-10-11 08:30:00,991004.7,2405.5
Sell,210,4713.39,2021-10-11 08:45:00,989811.9,992217.4
Buy,210,4713.39,2021-10-11 08:45:00,989811.9,2405.5
Sell,210,4711.04,2021-10-11 09:00:00,989318.4,991723.9
Buy,210,4711.04,2021-10-11 09:00:00,989318.4,2405.5
Sell,210,4716.17,2021-10-11 09:15:00,990395.7000000001,992801.2000000001
Buy,210,4716.17,2021-10-11 09:15:00,990395.7000000001,2405.5
Sell,210,4715.48,2021-10-11 09:30:00,990250.7999999999,992656.2999999999
Buy,210,4715.48,2021-10-11 09:30:00,990250.7999999999,2405.5
Sell,210,4711.84,2021-10-11 09:45:00,989486.4,991891.9
Buy,210,4711.84,2021-10-11 09:45:00,989486.4,2405.5
Sell,210,4728.95,2021-10-11 10:00:00,993079.5,995485.0
Buy,210,4728.95,2021-10-11 10:00:00,993079.5,2405.5
Sell,210,4743.46,2021-10-11 10:15:00,996126.6,998532.1
Buy,210,4743.46,2021-10-11 10:15:00,996126.6,2405.5
Sell,210,4751.46,2021-10-11 10:30:00,997806.6,1000212.1
Buy,210,4751.46,2021-10-11 10:30:00,997806.6,2405.5
Sell,210,4743.33,2021-10-11 10:45:00,996099.2999999999,998504.7999999999
Buy,210,4743.33,2021-10-11 10:45:00,996099.2999999999,2405.5
Sell,210,4757.21,2021-10-11 11:00:00,999014.1,1001419.6
Buy,210,4757.21,2021-10-11 11:00:00,999014.1,2405.5
Sell,210,4738.51,2021-10-11 11:15:00,995087.1000000001,997492.6000000001
Buy,210,4738.51,2021-10-11 11:15:00,995087.1000000001,2405.5
Sell,210,4742.05,2021-10-11 11:30:00,995830.5,998236.0
Buy,210,4742.05,2021-10-11 11:30:00,995830.5,2405.5
Sell,210,4732.28,2021-10-11 11:45:00,993778.7999999999,996184.2999999999
Buy,210,4732.28,2021-10-11 11:45:00,993778.7999999999,2405.5
Sell,210,4753.01,2021-10-11 12:00:00,998132.1000000001,1000537.6000000001
Buy,210,4753.01,2021-10-11 12:00:00,998132.1000000001,2405.5
Sell,210,4729.66,2021-10-11 12:15:00,993228.6,995634.1
Buy,210,4729.66,2021-10-11 12:15:00,993228.6,2405.5
Sell,210,4737.09,2021-10-11 12:30:00,994788.9,997194.4
Buy,210,4737.09,2021-10-11 12:30:00,994788.9,2405.5
Sell,210,4712.76,2021-10-11 12:45:00,989679.6000000001,992085.1000000001
Buy,210,4712.76,2021-10-11 12:45:00,989679.6000000001,2405.5
Sell,210,4724.75,2021-10-11 13:00:00,992197.5,994603.0
Buy,210,4724.75,2021-10-11 13:00:00,992197.5,2405.5
Sell,210,4714.25,2021-10-11 13:15:00,989992.5,992398.0
Buy,210,4714.25,2021-10-11 13:15:00,989992.5,2405.5
Sell,210,4788.68,2021-10-11 13:30:00,1005622.8,1008028.3
Buy,210,4788.68,2021-10-11 13:30:00,1005622.8,2405.5
Sell,210,4796.16,2021-10-11 13:45:00,1007193.6,1009599.1
Buy,210,4796.16,2021-10-11 13:45:00,1007193.6,2405.5
Sell,210,4851.16,2021-10-11 14:00:00,1018743.6,1021149.1
Buy,210,4851.16,2021-10-11 14:00:00,1018743.6,2405.5
Sell,210,4833.95,2021-10-11 14:15:00,1015129.5,1017535.0
Buy,210,4833.95,2021-10-11 14:15:00,1015129.5,2405.5
Sell,210,4841.99,2021-10-11 14:30:00,1016817.8999999999,1019223.3999999999
Buy,210,4841.99,2021-10-11 14:30:00,1016817.8999999999,2405.5
Sell,210,4849.75,2021-10-11 14:45:00,1018447.5,1020853.0
Buy,210,4849.75,2021-10-11 14:45:00,1018447.5,2405.5
Sell,210,4848.97,2021-10-11 15:00:00,1018283.7000000001,1020689.2000000001
Buy,210,4848.97,2021-10-11 15:00:00,1018283.7000000001,2405.5
Sell,210,4841.08,2021-10-11 15:15:00,1016626.7999999999,1019032.2999999999
Buy,210,4841.08,2021-10-11 15:15:00,1016626.7999999999,2405.5
Sell,210,4852.33,2021-10-11 15:30:00,1018989.2999999999,1021394.7999999999
Buy,210,4852.33,2021-10-11 15:30:00,1018989.2999999999,2405.5
Sell,210,4850.95,2021-10-11 15:45:00,1018699.5,1021105.0
Buy,210,4850.95,2021-10-11 15:45:00,1018699.5,2405.5
Sell,210,4846.97,2021-10-11 16:00:00,1017863.7000000001,1020269.2000000001
Buy,210,4846.97,2021-10-11 16:00:00,1017863.7000000001,2405.5
Sell,210,4850.66,2021-10-11 16:15:00,1018638.6,1021044.1
Buy,210,4850.66,2021-10-11 16:15:00,1018638.6,2405.5
Sell,210,4840.54,2021-10-11 16:30:00,1016513.4,1018918.9
Buy,210,4840.54,2021-10-11 16:30:00,1016513.4,2405.5
Sell,210,4852.08,2021-10-11 16:45:00,1018936.7999999999,1021342.2999999999
Buy,210,4852.08,2021-10-11 16:45:00,1018936.7999999999,2405.5
Sell,210,4844.44,2021-10-11 17:00:00,1017332.3999999999,1019737.8999999999
Buy,210,4844.44,2021-10-11 17:00:00,1017332.3999999999,2405.5
Sell,210,4849.56,2021-10-11 17:15:00,1018407.6000000001,1020813.1000000001
Buy,210,4849.56,2021-10-11 17:15:00,1018407.6000000001,2405.5
Sell,210,4840.75,2021-10-11 17:30:00,1016557.5,1018963.0
Buy,210,4840.75,2021-10-11 17:30:00,1016557.5,2405.5
Sell,210,4844.63,2021-10-11 17:45:00,1017372.3,1019777.8
Buy,210,4844.63,2021-10-11 17:45:00,1017372.3,2405.5
Sell,210,4823.39,2021-10-11 18:00:00,1012911.9,1015317.4
Buy,210,4823.39,2021-10-11 18:00:00,1012911.9,2405.5
Sell,210,4817.4,2021-10-11 18:15:00,1011653.9999999999,1014059.4999999999
Buy,210,4817.4,2021-10-11 18:15:00,1011653.9999999999,2405.5
Sell,210,4800.51,2021-10-11 18:30:00,1008107.1000000001,1010512.6000000001
Buy,210,4800.51,2021-10-11 18:30:00,1008107.1000000001,2405.5
Sell,210,4786.98,2021-10-11 18:45:00,1005265.7999999999,1007671.2999999999
Buy,210,4786.98,2021-10-11 18:45:00,1005265.7999999999,2405.5
Sell,210,4808.07,2021-10-11 19:00:00,1009694.7,1012100.2
Buy,210,4808.07,2021-10-11 19:00:00,1009694.7,2405.5
Sell,210,4786.5,2021-10-11 19:15:00,1005165.0,1007570.5
Buy,210,4786.5,2021-10-11 19:15:00,1005165.0,2405.5
Sell,210,4739.73,2021-10-11 19:30:00,995343.2999999999,997748.7999999999
Buy,210,4739.73,2021-10-11 19:30:00,995343.2999999999,2405.5
Sell,210,4706.16,2021-10-11 19:45:00,988293.6,990699.1
Buy,210,4706.16,2021-10-11 19:45:00,988293.6,2405.5
Sell,210,4696.0,2021-10-11 20:00:00,986160.0,988565.5
Buy,210,4696.0,2021-10-11 20:00:00,986160.0,2405.5
Sell,210,4702.57,2021-10-11 20:15:00,987539.7,989945.2
Buy,210,4702.57,2021-10-11 20:15:00,987539.7,2405.5
Sell,210,4675.02,2021-10-11 20:30:00,981754.2000000001,984159.7000000001
Buy,210,4675.02,2021-10-11 20:30:00,981754.2000000001,2405.5
Sell,210,4641.27,2021-10-11 20:45:00,974666.7000000001,977072.2000000001
Buy,210,4641.27,2021-10-11 20:45:00,974666.7000000001,2405.5
Sell,210,4624.26,2021-10-11 21:00:00,971094.6000000001,973500.1000000001
Buy,210,4624.26,2021-10-11 21:00:00,971094.6000000001,2405.5
Sell,210,4581.28,2021-10-11 21:15:00,962068.7999999999,964474.2999999999
Buy,210,4581.28,2021-10-11 21:15:00,962068.7999999999,2405.5
Sell,210,4623.42,2021-10-11 21:30:00,970918.2000000001,973323.7000000001
Buy,210,4623.42,2021-10-11 21:30:00,970918.2000000001,2405.5
Sell,210,4557.42,2021-10-11 21:45:00,957058.2000000001,959463.7000000001
Buy,210,4557.42,2021-10-11 21:45:00,957058.2000000001,2405.5
Sell,210,4606.33,2021-10-11 22:00:00,967329.2999999999,969734.7999999999
Buy,210,4606.33,2021-10-11 22:00:00,967329.2999999999,2405.5
Sell,210,4592.51,2021-10-11 22:15:00,964427.1000000001,966832.6000000001
Buy,210,4592.51,2021-10-11 22:15:00,964427.1000000001,2405.5
Sell,210,4613.13,2021-10-11 22:30:00,968757.3,971162.8
Buy,210,4613.13,2021-10-11 22:30:00,968757.3,2405.5
Sell,210,4644.64,2021-10-11 22:45:00,975374.4,977779.9
Buy,210,4644.64,2021-10-11 22:45:00,975374.4,2405.5
Sell,210,4632.0,2021-10-11 23:00:00,972720.0,975125.5
Buy,210,4632.0,2021-10-11 23:00:00,972720.0,2405.5
Sell,210,4604.42,2021-10-11 23:15:00,966928.2000000001,969333.7000000001
Buy,210,4604.42,2021-10-11 23:15:00,966928.2000000001,2405.5
Sell,210,4615.97,2021-10-11 23:30:00,969353.7000000001,971759.2000000001
Buy,210,4615.97,2021-10-11 23:30:00,969353.7000000001,2405.5
Sell,210,4632.21,2021-10-11 23:45:00,972764.1,975169.6
Buy,210,4632.21,2021-10-11 23:45:00,972764.1,2405.5
Sell,210,4136.88,2021-10-12 00:00:00,868744.8,871150.3
Buy,208,4180.6,2021-10-12 02:30:00,869564.8,1585.5
Sell,208,4164.81,2021-10-12 02:45:00,866280.4800000001,867865.9800000001
Buy,209,4146.07,2021-10-12 04:00:00,866528.6299999999,1337.3500000002095
Sell,209,4155.0,2021-10-12 04:15:00,868395.0,869732.3500000002
Buy,211,4119.68,2021-10-12 05:45:00,869252.4800000001,479.87000000011176
Sell,211,4130.16,2021-10-12 06:00:00,871463.76,871943.6300000001
Buy,211,4113.47,2021-10-12 06:15:00,867942.17,4001.460000000079
Sell,211,4121.33,2021-10-12 06:30:00,869600.63,873602.0900000001
Buy,211,4121.33,2021-10-12 06:30:00,869600.63,4001.460000000079
Sell,211,4065.54,2021-10-12 06:45:00,857828.94,861830.4
Buy,211,4065.54,2021-10-12 06:45:00,857828.94,4001.460000000079
Sell,211,4063.09,2021-10-12 07:00:00,857311.99,861313.4500000001
Buy,211,4073.71,2021-10-12 09:00:00,859552.81,1760.640000000014
Sell,211,4058.09,2021-10-12 09:15:00,856256.99,858017.63
Buy,211,4058.09,2021-10-12 09:15:00,856256.99,1760.640000000014
Sell,211,4093.95,2021-10-12 09:30:00,863823.45,865584.09
Buy,206,4182.87,2021-10-12 12:00:00,861671.22,3912.8699999999953
Sell,206,4156.62,2021-10-12 12:15:00,856263.72,860176.59
Buy,204,4200.59,2021-10-12 13:30:00,856920.36,3256.2299999999814
Sell,204,4200.96,2021-10-12 13:45:00,856995.84,860252.07
Buy,204,4200.96,2021-10-12 13:45:00,856995.84,3256.2299999999814
Sell,204,4198.13,2021-10-12 14:00:00,856418.52,859674.75
Buy,204,4198.13,2021-10-12 14:00:00,856418.52,3256.2299999999814
Sell,204,4175.47,2021-10-12 14:15:00,851795.88,855052.11
Buy,204,4175.47,2021-10-12 14:15:00,851795.88,3256.2299999999814
Sell,204,4170.92,2021-10-12 14:30:00,850867.68,854123.91
Buy,214,3987.73,2021-10-12 16:00:00,853374.22,749.6900000000605
Sell,214,3990.79,2021-10-12 16:15:00,854029.0599999999,854778.75
Buy,212,4014.81,2021-10-12 19:45:00,851139.72,3639.030000000028
Sell,212,4022.02,2021-10-12 20:00:00,852668.24,856307.27
Buy,212,4037.5,2021-10-12 21:00:00,855950.0,357.2700000000186
Sell,212,4034.74,2021-10-12 21:15:00,855364.88,855722.15
Buy,214,3982.97,2021-10-12 22:15:00,852355.58,3366.570000000065
Sell,214,3986.08,2021-10-12 22:30:00,853021.12,856387.6900000001
Buy,207,4136.93,2021-10-20 22:30:00,856344.51,43.18000000005122
Sell,207,4129.29,2021-10-20 22:45:00,854763.03,854806.2100000001
Buy,203,4200.74,2021-10-21 00:15:00,852750.22,2055.990000000107
Sell,203,4208.79,2021-10-21 00:30:00,854384.37,856440.3600000001
Buy,203,4208.79,2021-10-21 00:30:00,854384.37,2055.990000000107
Sell,203,4193.7,2021-10-21 00:45:00,851321.1,853377.0900000001
Buy,203,4193.7,2021-10-21 00:45:00,851321.1,2055.990000000107
Sell,203,4233.7,2021-10-21 01:00:00,859441.1,861497.0900000001
Buy,203,4233.7,2021-10-21 01:00:00,859441.1,2055.990000000107
Sell,203,4233.07,2021-10-21 01:15:00,859313.21,861369.2000000001
Buy,203,4233.07,2021-10-21 01:15:00,859313.21,2055.990000000107
Sell,203,4219.42,2021-10-21 01:30:00,856542.26,858598.2500000001
Buy,203,4219.42,2021-10-21 01:30:00,856542.26,2055.990000000107
Sell,203,4201.66,2021-10-21 01:45:00,852936.98,854992.9700000001
Buy,203,4201.66,2021-10-21 01:45:00,852936.98,2055.990000000107
Sell,203,4204.26,2021-10-21 02:00:00,853464.78,855520.7700000001
Buy,203,4204.26,2021-10-21 02:00:00,853464.78,2055.990000000107
Sell,203,4187.7,2021-10-21 02:15:00,850103.1,852159.0900000001
Buy,203,4187.7,2021-10-21 02:15:00,850103.1,2055.990000000107
Sell,203,4207.3,2021-10-21 02:30:00,854081.9,856137.8900000001
Buy,203,4207.3,2021-10-21 02:30:00,854081.9,2055.990000000107
Sell,203,4199.49,2021-10-21 02:45:00,852496.47,854552.4600000001
Buy,203,4199.49,2021-10-21 02:45:00,852496.47,2055.990000000107
Sell,203,4179.05,2021-10-21 03:00:00,848347.15,850403.1400000001
Buy,203,4179.05,2021-10-21 03:00:00,848347.15,2055.990000000107
Sell,203,4159.7,2021-10-21 03:15:00,844419.1,846475.0900000001
Buy,202,4190.0,2021-10-21 03:45:00,846380.0,95.09000000008382
Sell,202,4182.14,2021-10-21 04:00:00,844792.28,844887.3700000001
Buy,202,4182.14,2021-10-21 04:00:00,844792.28,95.09000000008382
Sell,202,4163.2,2021-10-21 04:15:00,840966.3999999999,841061.49
Buy,200,4188.75,2021-10-21 05:00:00,837750.0,3311.4899999999907
Sell,200,4179.07,2021-10-21 05:15:00,835814.0,839125.49
Buy,200,4179.07,2021-10-21 05:15:00,835814.0,3311.4899999999907
Sell,200,4182.61,2021-10-21 05:30:00,836521.9999999999,839833.4899999999
Buy,200,4182.61,2021-10-21 05:30:00,836521.9999999999,3311.4899999999907
Sell,200,4178.71,2021-10-21 05:45:00,835742.0,839053.49
Buy,200,4178.71,2021-10-21 05:45:00,835742.0,3311.4899999999907
Sell,200,4167.56,2021-10-21 06:00:00,833512.0000000001,836823.4900000001
Buy,199,4184.6,2021-10-21 08:15:00,832735.4,4088.090000000084
Sell,199,4203.27,2021-10-21 08:30:00,836450.7300000001,840538.8200000002
Buy,199,4203.27,2021-10-21 08:30:00,836450.7300000001,4088.090000000084
Sell,199,4200.02,2021-10-21 08:45:00,835803.9800000001,839892.0700000002
Buy,199,4200.02,2021-10-21 08:45:00,835803.9800000001,4088.090000000084
Sell,199,4225.29,2021-10-21 09:00:00,840832.71,844920.8
Buy,199,4225.29,2021-10-21 09:00:00,840832.71,4088.090000000084
Sell,199,4234.66,2021-10-21 09:15:00,842697.34,846785.43
Buy,199,4234.66,2021-10-21 09:15:00,842697.34,4088.090000000084
Sell,199,4288.0,2021-10-21 09:30:00,853312.0,857400.0900000001
Buy,199,4288.0,2021-10-21 09:30:00,853312.0,4088.090000000084
Sell,199,4306.69,2021-10-21 09:45:00,857031.3099999999,861119.4
Buy,199,4306.69,2021-10-21 09:45:00,857031.3099999999,4088.090000000084
Sell,199,4298.83,2021-10-21 10:00:00,855467.17,859555.2600000001
Buy,199,4298.83,2021-10-21 10:00:00,855467.17,4088.090000000084
Sell,199,4295.95,2021-10-21 10:15:00,854894.0499999999,858982.14
Buy,199,4295.95,2021-10-21 10:15:00,854894.0499999999,4088.090000000084
Sell,199,4310.0,2021-10-21 10:30:00,857690.0,861778.0900000001
Buy,199,4310.0,2021-10-21 10:30:00,857690.0,4088.090000000084
Sell,199,4313.4,2021-10-21 10:45:00,858366.6,862454.6900000001
Buy,199,4313.4,2021-10-21 10:45:00,858366.6,4088.090000000084
Sell,199,4330.6,2021-10-21 11:00:00,861789.4,865877.4900000001
Buy,199,4330.6,2021-10-21 11:00:00,861789.4,4088.090000000084
Sell,199,4370.29,2021-10-21 11:15:00,869687.71,873775.8
Buy,199,4370.29,2021-10-21 11:15:00,869687.71,4088.090000000084
Sell,199,4258.79,2021-10-21 11:30:00,847499.21,851587.3
Buy,199,4258.79,2021-10-21 11:30:00,847499.21,4088.090000000084
Sell,199,4219.13,2021-10-21 11:45:00,839606.87,843694.9600000001
Buy,199,4219.13,2021-10-21 11:45:00,839606.87,4088.090000000084
Sell,199,4169.15,2021-10-21 12:00:00,829660.85,833748.9400000001
Buy,199,4169.15,2021-10-21 12:00:00,829660.85,4088.090000000084
Sell,199,4208.24,2021-10-21 12:15:00,837439.76,841527.8500000001
Buy,199,4208.24,2021-10-21 12:15:00,837439.76,4088.090000000084
Sell,199,4224.42,2021-10-21 12:30:00,840659.58,844747.67
Buy,199,4224.42,2021-10-21 12:30:00,840659.58,4088.090000000084
Sell,199,4232.65,2021-10-21 12:45:00,842297.35,846385.4400000001
Buy,199,4232.65,2021-10-21 12:45:00,842297.35,4088.090000000084
Sell,199,4226.43,2021-10-21 13:00:00,841059.5700000001,845147.6600000001
Buy,199,4226.43,2021-10-21 13:00:00,841059.5700000001,4088.090000000084
Sell,199,4262.94,2021-10-21 13:15:00,848325.0599999999,852413.15
Buy,199,4262.94,2021-10-21 13:15:00,848325.0599999999,4088.090000000084
Sell,199,4246.2,2021-10-21 13:30:00,844993.7999999999,849081.89
Buy,199,4246.2,2021-10-21 13:30:00,844993.7999999999,4088.090000000084
Sell,199,4221.37,2021-10-21 13:45:00,840052.63,844140.7200000001
Buy,199,4221.37,2021-10-21 13:45:00,840052.63,4088.090000000084
Sell,199,4195.0,2021-10-21 14:00:00,834805.0,838893.0900000001
Buy,199,4195.0,2021-10-21 14:00:00,834805.0,4088.090000000084
Sell,199,4133.64,2021-10-21 14:15:00,822594.3600000001,826682.4500000002
Buy,199,4133.64,2021-10-21 14:15:00,822594.3600000001,4088.090000000084
Sell,199,4139.74,2021-10-21 14:30:00,823808.26,827896.3500000001
Buy,201,4112.67,2021-10-21 15:00:00,826646.67,1249.6800000000512
Sell,201,4038.94,2021-10-21 15:15:00,811826.9400000001,813076.6200000001
Buy,196,4135.64,2021-10-21 16:15:00,810585.4400000001,2491.180000000051
Sell,196,4103.99,2021-10-21 16:30:00,804382.0399999999,806873.22
Buy,196,4103.99,2021-10-21 16:30:00,804382.0399999999,2491.180000000051
Sell,196,4061.0,2021-10-21 16:45:00,795956.0,798447.18
Buy,195,4083.91,2021-10-21 21:30:00,796362.45,2084.730000000098
Sell,195,4095.86,2021-10-21 21:45:00,798692.7000000001,800777.4300000002
Buy,195,4104.26,2021-10-21 22:00:00,800330.7000000001,446.7300000000978
Sell,195,4111.81,2021-10-21 22:15:00,801802.9500000001,802249.6800000002
Buy,195,4111.81,2021-10-21 22:15:00,801802.9500000001,446.7300000000978
Sell,195,4080.73,2021-10-21 22:30:00,795742.35,796189.0800000001
Buy,195,4072.65,2021-10-21 22:45:00,794166.75,2022.3300000000745
Sell,195,4087.14,2021-10-21 23:00:00,796992.2999999999,799014.63
Buy,195,4087.14,2021-10-21 23:00:00,796992.2999999999,2022.3300000000745
Sell,195,4061.84,2021-10-21 23:15:00,792058.8,794081.1300000001
Buy,194,4077.17,2021-10-21 23:30:00,790970.98,3110.1500000001397
Sell,194,4057.26,2021-10-21 23:45:00,787108.4400000001,790218.5900000002
Buy,193,4084.44,2021-10-22 00:00:00,788296.92,1921.6700000001583
Sell,193,4107.43,2021-10-22 00:15:00,792733.9900000001,794655.6600000003
Buy,193,4107.43,2021-10-22 00:15:00,792733.9900000001,1921.6700000001583
Sell,193,4127.41,2021-10-22 00:30:00,796590.13,798511.8000000002
Buy,193,4127.08,2021-10-22 01:30:00,796526.44,1985.3600000002189
Sell,193,4107.45,2021-10-22 01:45:00,792737.85,794723.2100000002
Buy,193,4107.45,2021-10-22 01:45:00,792737.85,1985.3600000002189
Sell,193,4124.99,2021-10-22 02:00:00,796123.07,798108.4300000002
Buy,193,4130.04,2021-10-22 02:15:00,797097.72,1010.7100000001956
Sell,193,4115.82,2021-10-22 02:30:00,794353.2599999999,795363.9700000001
Buy,193,4115.82,2021-10-22 02:30:00,794353.2599999999,1010.7100000001956
Sell,193,4116.19,2021-10-22 02:45:00,794424.6699999999,795435.3800000001
Buy,191,4149.74,2021-10-22 04:15:00,792600.34,2835.0400000001537
Sell,191,4147.55,2021-10-22 04:30:00,792182.05,795017.0900000002
Buy,191,4147.55,2021-10-22 04:30:00,792182.05,2835.0400000001537
Sell,191,4153.11,2021-10-22 04:45:00,793244.0099999999,796079.05
Buy,191,4153.11,2021-10-22 04:45:00,793244.0099999999,2835.0400000001537
Sell,191,4146.72,2021-10-22 05:00:00,792023.52,794858.5600000002
Buy,191,4146.72,2021-10-22 05:00:00,792023.52,2835.0400000001537
Sell,191,4128.71,2021-10-22 05:15:00,788583.61,791418.6500000001
Buy,191,4128.71,2021-10-22 05:15:00,788583.61,2835.0400000001537
Sell,191,4135.56,2021-10-22 05:30:00,789891.9600000001,792727.0000000002
Buy,191,4135.56,2021-10-22 05:30:00,789891.9600000001,2835.0400000001537
Sell,191,4134.61,2021-10-22 05:45:00,789710.5099999999,792545.55
Buy,191,4134.61,2021-10-22 05:45:00,789710.5099999999,2835.0400000001537
Sell,191,4141.02,2021-10-22 06:00:00,790934.8200000001,793769.8600000002
Buy,191,4141.02,2021-10-22 06:00:00,790934.8200000001,2835.0400000001537
Sell,191,4116.68,2021-10-22 06:15:00,786285.88,789120.9200000002
Buy,191,4116.68,2021-10-22 06:15:00,786285.88,2835.0400000001537
Sell,191,4114.99,2021-10-22 06:30:00,785963.09,788798.1300000001
Buy,191,4114.99,2021-10-22 06:30:00,785963.09,2835.0400000001537
Sell,191,4121.86,2021-10-22 06:45:00,787275.2599999999,790110.3
Buy,191,4121.86,2021-10-22 06:45:00,787275.2599999999,2835.0400000001537
Sell,191,4116.18,2021-10-22 07:00:00,786190.38,789025.4200000002
Buy,191,4116.18,2021-10-22 07:00:00,786190.38,2835.0400000001537
Sell,191,4130.78,2021-10-22 07:15:00,788978.98,791814.0200000001
Buy,191,4130.78,2021-10-22 07:15:00,788978.98,2835.0400000001537
Sell,191,4146.77,2021-10-22 07:30:00,792033.0700000001,794868.1100000002
Buy,191,4146.77,2021-10-22 07:30:00,792033.0700000001,2835.0400000001537
Sell,191,4147.35,2021-10-22 07:45:00,792143.8500000001,794978.8900000002
Buy,191,4147.35,2021-10-22 07:45:00,792143.8500000001,2835.0400000001537
Sell,191,4156.91,2021-10-22 08:00:00,793969.8099999999,796804.8500000001
Buy,191,4156.91,2021-10-22 08:00:00,793969.8099999999,2835.0400000001537
Sell,191,4141.65,2021-10-22 08:15:00,791055.1499999999,793890.1900000001
Buy,191,4141.65,2021-10-22 08:15:00,791055.1499999999,2835.0400000001537
Sell,191,4149.36,2021-10-22 08:30:00,792527.7599999999,795362.8
Buy,191,4149.36,2021-10-22 08:30:00,792527.7599999999,2835.0400000001537
Sell,191,4148.92,2021-10-22 08:45:00,792443.72,795278.7600000001
Buy,191,4148.92,2021-10-22 08:45:00,792443.72,2835.0400000001537
Sell,191,4137.83,2021-10-22 09:00:00,790325.53,793160.5700000002
Buy,191,4137.83,2021-10-22 09:00:00,790325.53,2835.0400000001537
Sell,191,4134.44,2021-10-22 09:15:00,789678.0399999999,792513.0800000001
Buy,191,4134.44,2021-10-22 09:15:00,789678.0399999999,2835.0400000001537
Sell,191,4126.84,2021-10-22 09:30:00,788226.4400000001,791061.4800000002
Buy,191,4126.84,2021-10-22 09:30:00,788226.4400000001,2835.0400000001537
Sell,191,4125.05,2021-10-22 09:45:00,787884.55,790719.5900000002
Buy,191,4125.05,2021-10-22 09:45:00,787884.55,2835.0400000001537
Sell,191,4121.67,2021-10-22 10:00:00,787238.97,790074.0100000001
Buy,191,4121.67,2021-10-22 10:00:00,787238.97,2835.0400000001537
Sell,191,4097.54,2021-10-22 10:15:00,782630.14,785465.1800000002
Buy,191,4097.54,2021-10-22 10:15:00,782630.14,2835.0400000001537
Sell,191,4109.92,2021-10-22 10:30:00,784994.72,787829.7600000001
Buy,191,4109.92,2021-10-22 10:30:00,784994.72,2835.0400000001537
Sell,191,4113.9,2021-10-22 10:45:00,785754.8999999999,788589.9400000001
Buy,191,4113.9,2021-10-22 10:45:00,785754.8999999999,2835.0400000001537
Sell,191,4119.23,2021-10-22 11:00:00,786772.9299999999,789607.9700000001
Buy,191,4119.23,2021-10-22 11:00:00,786772.9299999999,2835.0400000001537
Sell,191,4125.24,2021-10-22 11:15:00,787920.84,790755.8800000001
Buy,191,4125.24,2021-10-22 11:15:00,787920.84,2835.0400000001537
Sell,191,4122.5,2021-10-22 11:30:00,787397.5,790232.5400000002
Buy,191,4122.5,2021-10-22 11:30:00,787397.5,2835.0400000001537
Sell,191,4127.96,2021-10-22 11:45:00,788440.36,791275.4000000001
Buy,191,4127.96,2021-10-22 11:45:00,788440.36,2835.0400000001537
Sell,191,4117.52,2021-10-22 12:00:00,786446.3200000001,789281.3600000002
Buy,191,4117.52,2021-10-22 12:00:00,786446.3200000001,2835.0400000001537
Sell,191,4119.68,2021-10-22 12:15:00,786858.88,789693.9200000002
Buy,191,4119.68,2021-10-22 12:15:00,786858.88,2835.0400000001537
Sell,191,4124.49,2021-10-22 12:30:00,787777.59,790612.6300000001
Buy,191,4124.49,2021-10-22 12:30:00,787777.59,2835.0400000001537
Sell,191,4142.25,2021-10-22 12:45:00,791169.75,794004.7900000002
Buy,191,4142.25,2021-10-22 12:45:00,791169.75,2835.0400000001537
Sell,191,4131.86,2021-10-22 13:00:00,789185.2599999999,792020.3
Buy,191,4131.86,2021-10-22 13:00:00,789185.2599999999,2835.0400000001537
Sell,191,4116.87,2021-10-22 13:15:00,786322.1699999999,789157.2100000001
Buy,191,4116.87,2021-10-22 13:15:00,786322.1699999999,2835.0400000001537
Sell,191,4108.8,2021-10-22 13:30:00,784780.8,787615.8400000002
Buy,191,4108.8,2021-10-22 13:30:00,784780.8,2835.0400000001537
Sell,191,4068.48,2021-10-22 13:45:00,777079.68,779914.7200000002
Buy,191,4068.48,2021-10-22 13:45:00,777079.68,2835.0400000001537
Sell,191,4044.15,2021-10-22 14:00:00,772432.65,775267.6900000002
Buy,191,4044.15,2021-10-22 14:00:00,772432.65,2835.0400000001537
Sell,191,4026.31,2021-10-22 14:15:00,769025.21,771860.2500000001
Buy,191,4026.31,2021-10-22 14:15:00,769025.21,2835.0400000001537
Sell,191,4005.92,2021-10-22 14:30:00,765130.72,767965.7600000001
Buy,191,4005.92,2021-10-22 14:30:00,765130.72,2835.0400000001537
Sell,191,4029.95,2021-10-22 14:45:00,769720.45,772555.4900000001
Buy,191,4029.95,2021-10-22 14:45:00,769720.45,2835.0400000001537
Sell,191,4027.19,2021-10-22 15:00:00,769193.29,772028.3300000002
Buy,191,4027.19,2021-10-22 15:00:00,769193.29,2835.0400000001537
Sell,191,3979.8,2021-10-22 15:15:00,760141.8,762976.8400000002
Buy,191,3979.8,2021-10-22 15:15:00,760141.8,2835.0400000001537
Sell,191,3994.09,2021-10-22 15:30:00,762871.1900000001,765706.2300000002
Buy,193,3959.55,2021-10-22 19:30:00,764193.15,1513.080000000191
Sell,193,3986.7,2021-10-22 19:45:00,769433.1,770946.1800000002
Buy,193,3990.85,2021-10-22 20:15:00,770234.0499999999,712.1300000002375
Sell,193,3996.38,2021-10-22 20:30:00,771301.34,772013.4700000002
Buy,193,3980.01,2021-10-22 20:45:00,768141.93,3871.5400000001537
Sell,193,3976.65,2021-10-22 21:00:00,767493.4500000001,771364.9900000002
Buy,192,4011.54,2021-10-23 01:45:00,770215.6799999999,1149.3100000002887
Sell,192,4017.09,2021-10-23 02:00:00,771281.28,772430.5900000003
Buy,192,4018.93,2021-10-23 02:15:00,771634.5599999999,796.0300000003772
Sell,192,4027.53,2021-10-23 02:30:00,773285.76,774081.7900000004
Buy,192,4027.53,2021-10-23 02:30:00,773285.76,796.0300000003772
Sell,192,4030.62,2021-10-23 02:45:00,773879.04,774675.0700000004
Buy,192,4030.62,2021-10-23 02:45:00,773879.04,796.0300000003772
Sell,192,4028.46,2021-10-23 03:00:00,773464.3200000001,774260.3500000004
Buy,192,4024.5,2021-10-23 03:15:00,772704.0,1556.3500000004424
Sell,192,4031.19,2021-10-23 03:30:00,773988.48,775544.8300000004
Buy,192,4025.96,2021-10-23 03:45:00,772984.3200000001,2560.5100000003586
Sell,192,4044.74,2021-10-23 04:00:00,776590.08,779150.5900000003
Buy,192,4042.96,2021-10-23 11:45:00,776248.3200000001,2902.2700000002515
Sell,192,4036.16,2021-10-23 12:00:00,774942.72,777844.9900000002
Buy,192,4030.43,2021-10-23 14:00:00,773842.5599999999,4002.430000000284
Sell,192,4023.83,2021-10-23 14:15:00,772575.36,776577.7900000003
Buy,189,4094.09,2021-10-23 15:15:00,773783.01,2794.7800000002608
Sell,189,4064.0,2021-10-23 15:30:00,768096.0,770890.7800000003
Buy,189,4064.0,2021-10-23 15:30:00,768096.0,2794.7800000002608
Sell,189,4089.99,2021-10-23 15:45:00,773008.11,775802.8900000002
Buy,189,4089.99,2021-10-23 15:45:00,773008.11,2794.7800000002608
Sell,189,4112.24,2021-10-23 16:00:00,777213.36,780008.1400000002
Buy,189,4112.24,2021-10-23 16:00:00,777213.36,2794.7800000002608
Sell,189,4108.5,2021-10-23 16:15:00,776506.5,779301.2800000003
Buy,189,4108.5,2021-10-23 16:15:00,776506.5,2794.7800000002608
Sell,189,4085.11,2021-10-23 16:30:00,772085.79,774880.5700000003
Buy,189,4085.11,2021-10-23 16:30:00,772085.79,2794.7800000002608
Sell,189,4089.33,2021-10-23 16:45:00,772883.37,775678.1500000003
Buy,189,4089.33,2021-10-23 16:45:00,772883.37,2794.7800000002608
Sell,189,4096.0,2021-10-23 17:00:00,774144.0,776938.7800000003
Buy,189,4096.0,2021-10-23 17:00:00,774144.0,2794.7800000002608
Sell,189,4094.85,2021-10-23 17:15:00,773926.65,776721.4300000003
Buy,189,4094.85,2021-10-23 17:15:00,773926.65,2794.7800000002608
Sell,189,4098.26,2021-10-23 17:30:00,774571.14,777365.9200000003
Buy,189,4098.26,2021-10-23 17:30:00,774571.14,2794.7800000002608
Sell,189,4107.89,2021-10-23 17:45:00,776391.2100000001,779185.9900000003
Buy,189,4107.89,2021-10-23 17:45:00,776391.2100000001,2794.7800000002608
Sell,189,4112.58,2021-10-23 18:00:00,777277.62,780072.4000000003
Buy,189,4112.58,2021-10-23 18:00:00,777277.62,2794.7800000002608
Sell,189,4112.28,2021-10-23 18:15:00,777220.9199999999,780015.7000000002
Buy,189,4112.28,2021-10-23 18:15:00,777220.9199999999,2794.7800000002608
Sell,189,4106.01,2021-10-23 18:30:00,776035.89,778830.6700000003
Buy,189,4106.01,2021-10-23 18:30:00,776035.89,2794.7800000002608
Sell,189,4115.7,2021-10-23 18:45:00,777867.2999999999,780662.0800000002
Buy,189,4115.7,2021-10-23 18:45:00,777867.2999999999,2794.7800000002608
Sell,189,4102.7,2021-10-23 19:00:00,775410.2999999999,778205.0800000002
Buy,189,4102.7,2021-10-23 19:00:00,775410.2999999999,2794.7800000002608
Sell,189,4093.77,2021-10-23 19:15:00,773722.53,776517.3100000003
Buy,189,4093.77,2021-10-23 19:15:00,773722.53,2794.7800000002608
Sell,189,4091.03,2021-10-23 19:30:00,773204.67,775999.4500000003
Buy,189,4091.03,2021-10-23 19:30:00,773204.67,2794.7800000002608
Sell,189,4086.51,2021-10-23 19:45:00,772350.39,775145.1700000003
Buy,189,4086.51,2021-10-23 19:45:00,772350.39,2794.7800000002608
Sell,189,4087.11,2021-10-23 20:00:00,772463.79,775258.5700000003
Buy,189,4087.11,2021-10-23 20:00:00,772463.79,2794.7800000002608
Sell,189,4082.85,2021-10-23 20:15:00,771658.65,774453.4300000003
Buy,189,4082.85,2021-10-23 20:15:00,771658.65,2794.7800000002608
Sell,189,4080.14,2021-10-23 20:30:00,771146.46,773941.2400000002
Buy,189,4080.14,2021-10-23 20:30:00,771146.46,2794.7800000002608
Sell,189,4091.14,2021-10-23 20:45:00,773225.46,776020.2400000002
Buy,189,4091.14,2021-10-23 20:45:00,773225.46,2794.7800000002608
Sell,189,4095.73,2021-10-23 21:00:00,774092.97,776887.7500000002
Buy,189,4095.73,2021-10-23 21:00:00,774092.97,2794.7800000002608
Sell,189,4095.19,2021-10-23 21:15:00,773990.91,776785.6900000003
Buy,189,4095.19,2021-10-23 21:15:00,773990.91,2794.7800000002608
Sell,189,4107.19,2021-10-23 21:30:00,776258.9099999999,779053.6900000002
Buy,189,4107.19,2021-10-23 21:30:00,776258.9099999999,2794.7800000002608
Sell,189,4093.14,2021-10-23 21:45:00,773603.46,776398.2400000002
Buy,189,4093.14,2021-10-23 21:45:00,773603.46,2794.7800000002608
Sell,189,4123.75,2021-10-23 22:00:00,779388.75,782183.5300000003
Buy,189,4123.75,2021-10-23 22:00:00,779388.75,2794.7800000002608
Sell,189,4125.54,2021-10-23 22:15:00,779727.0599999999,782521.8400000002
Buy,189,4125.54,2021-10-23 22:15:00,779727.0599999999,2794.7800000002608
Sell,189,4118.76,2021-10-23 22:30:00,778445.64,781240.4200000003
Buy,189,4118.76,2021-10-23 22:30:00,778445.64,2794.7800000002608
Sell,189,4120.12,2021-10-23 22:45:00,778702.6799999999,781497.4600000002
Buy,189,4120.12,2021-10-23 22:45:00,778702.6799999999,2794.7800000002608
Sell,189,4143.89,2021-10-23 23:00:00,783195.2100000001,785989.9900000003
Buy,189,4143.89,2021-10-23 23:00:00,783195.2100000001,2794.7800000002608
Sell,189,4176.67,2021-10-23 23:15:00,789390.63,792185.4100000003
Buy,189,4176.67,2021-10-23 23:15:00,789390.63,2794.7800000002608
Sell,189,4154.16,2021-10-23 23:30:00,785136.24,787931.0200000003
Buy,189,4154.16,2021-10-23 23:30:00,785136.24,2794.7800000002608
Sell,189,4170.5,2021-10-23 23:45:00,788224.5,791019.2800000003
Buy,189,4170.5,2021-10-23 23:45:00,788224.5,2794.7800000002608
Sell,189,4180.18,2021-10-24 00:00:00,790054.02,792848.8000000003
Buy,189,4180.18,2021-10-24 00:00:00,790054.02,2794.7800000002608
Sell,189,4163.82,2021-10-24 00:15:00,786961.98,789756.7600000002
Buy,189,4163.82,2021-10-24 00:15:00,786961.98,2794.7800000002608
Sell,189,4150.01,2021-10-24 00:30:00,784351.89,787146.6700000003
Buy,189,4150.01,2021-10-24 00:30:00,784351.89,2794.7800000002608
Sell,189,4145.15,2021-10-24 00:45:00,783433.35,786228.1300000002
Buy,189,4145.15,2021-10-24 00:45:00,783433.35,2794.7800000002608
Sell,189,4136.47,2021-10-24 01:00:00,781792.8300000001,784587.6100000003
Buy,189,4136.47,2021-10-24 01:00:00,781792.8300000001,2794.7800000002608
Sell,189,4134.0,2021-10-24 01:15:00,781326.0,784120.7800000003
Buy,189,4134.0,2021-10-24 01:15:00,781326.0,2794.7800000002608
Sell,189,4129.47,2021-10-24 01:30:00,780469.8300000001,783264.6100000003
Buy,189,4129.47,2021-10-24 01:30:00,780469.8300000001,2794.7800000002608
Sell,189,4135.17,2021-10-24 01:45:00,781547.13,784341.9100000003
Buy,189,4135.17,2021-10-24 01:45:00,781547.13,2794.7800000002608
Sell,189,4132.14,2021-10-24 02:00:00,780974.4600000001,783769.2400000003
Buy,189,4132.14,2021-10-24 02:00:00,780974.4600000001,2794.7800000002608
Sell,189,4129.24,2021-10-24 02:15:00,780426.36,783221.1400000002
Buy,189,4129.24,2021-10-24 02:15:00,780426.36,2794.7800000002608
Sell,189,4130.28,2021-10-24 02:30:00,780622.9199999999,783417.7000000002
Buy,189,4130.28,2021-10-24 02:30:00,780622.9199999999,2794.7800000002608
Sell,189,4143.37,2021-10-24 02:45:00,783096.9299999999,785891.7100000002
Buy,189,4143.37,2021-10-24 02:45:00,783096.9299999999,2794.7800000002608
Sell,189,4147.82,2021-10-24 03:00:00,783937.98,786732.7600000002
Buy,189,4147.82,2021-10-24 03:00:00,783937.98,2794.7800000002608
Sell,189,4138.48,2021-10-24 03:15:00,782172.72,784967.5000000002
Buy,189,4138.48,2021-10-24 03:15:00,782172.72,2794.7800000002608
Sell,189,4142.66,2021-10-24 03:30:00,782962.74,785757.5200000003
Buy,189,4142.66,2021-10-24 03:30:00,782962.74,2794.7800000002608
Sell,189,4137.87,2021-10-24 03:45:00,782057.4299999999,784852.2100000002
Buy,189,4137.87,2021-10-24 03:45:00,782057.4299999999,2794.7800000002608
Sell,189,4124.21,2021-10-24 04:00:00,779475.6900000001,782270.4700000003
Buy,189,4124.21,2021-10-24 04:00:00,779475.6900000001,2794.7800000002608
Sell,189,4115.85,2021-10-24 04:15:00,777895.65,780690.4300000003
Buy,189,4115.85,2021-10-24 04:15:00,777895.65,2794.7800000002608
Sell,189,4112.19,2021-10-24 04:30:00,777203.9099999999,779998.6900000002
Buy,189,4112.19,2021-10-24 04:30:00,777203.9099999999,2794.7800000002608
Sell,189,4111.03,2021-10-24 04:45:00,776984.6699999999,779779.4500000002
Buy,189,4111.03,2021-10-24 04:45:00,776984.6699999999,2794.7800000002608
Sell,189,4115.84,2021-10-24 05:00:00,777893.76,780688.5400000003
Buy,189,4115.84,2021-10-24 05:00:00,777893.76,2794.7800000002608
Sell,189,4125.92,2021-10-24 05:15:00,779798.88,782593.6600000003
Buy,189,4125.92,2021-10-24 05:15:00,779798.88,2794.7800000002608
Sell,189,4118.84,2021-10-24 05:30:00,778460.76,781255.5400000003
Buy,189,4118.84,2021-10-24 05:30:00,778460.76,2794.7800000002608
Sell,189,4114.34,2021-10-24 05:45:00,777610.26,780405.0400000003
Buy,189,4114.34,2021-10-24 05:45:00,777610.26,2794.7800000002608
Sell,189,4120.34,2021-10-24 06:00:00,778744.26,781539.0400000003
Buy,189,4120.34,2021-10-24 06:00:00,778744.26,2794.7800000002608
Sell,189,4111.89,2021-10-24 06:15:00,777147.2100000001,779941.9900000003
Buy,189,4111.89,2021-10-24 06:15:00,777147.2100000001,2794.7800000002608
Sell,189,4100.01,2021-10-24 06:30:00,774901.89,777696.6700000003
Buy,189,4100.01,2021-10-24 06:30:00,774901.89,2794.7800000002608
Sell,189,4093.99,2021-10-24 06:45:00,773764.11,776558.8900000002
Buy,189,4093.99,2021-10-24 06:45:00,773764.11,2794.7800000002608
Sell,189,4093.86,2021-10-24 07:00:00,773739.54,776534.3200000003
Buy,189,4093.86,2021-10-24 07:00:00,773739.54,2794.7800000002608
Sell,189,4098.9,2021-10-24 07:15:00,774692.1,777486.8800000002
Buy,189,4098.9,2021-10-24 07:15:00,774692.1,2794.7800000002608
Sell,189,4107.77,2021-10-24 07:30:00,776368.53,779163.3100000003
Buy,189,4107.77,2021-10-24 07:30:00,776368.53,2794.7800000002608
Sell,189,4098.84,2021-10-24 07:45:00,774680.76,777475.5400000003
Buy,189,4098.84,2021-10-24 07:45:00,774680.76,2794.7800000002608
Sell,189,4086.01,2021-10-24 08:00:00,772255.89,775050.6700000003
Buy,189,4086.01,2021-10-24 08:00:00,772255.89,2794.7800000002608
Sell,189,4091.63,2021-10-24 08:15:00,773318.0700000001,776112.8500000003
Buy,189,4091.63,2021-10-24 08:15:00,773318.0700000001,2794.7800000002608
Sell,189,4090.22,2021-10-24 08:30:00,773051.58,775846.3600000002
Buy,189,4090.22,2021-10-24 08:30:00,773051.58,2794.7800000002608
Sell,189,4076.6,2021-10-24 08:45:00,770477.4,773272.1800000003
Buy,188,4108.41,2021-10-24 09:00:00,772381.08,891.100000000326
Sell,188,4123.53,2021-10-24 09:15:00,775223.6399999999,776114.7400000002
Buy,188,4123.53,2021-10-24 09:15:00,775223.6399999999,891.100000000326
Sell,188,4111.37,2021-10-24 09:30:00,772937.5599999999,773828.6600000003
Buy,188,4111.37,2021-10-24 09:30:00,772937.5599999999,891.100000000326
Sell,188,4095.89,2021-10-24 09:45:00,770027.32,770918.4200000003
Buy,188,4095.89,2021-10-24 09:45:00,770027.32,891.100000000326
Sell,188,4102.61,2021-10-24 10:00:00,771290.6799999999,772181.7800000003
Buy,188,4102.61,2021-10-24 10:00:00,771290.6799999999,891.100000000326
Sell,188,4108.83,2021-10-24 10:15:00,772460.04,773351.1400000004
Buy,188,4108.83,2021-10-24 10:15:00,772460.04,891.100000000326
Sell,188,4093.44,2021-10-24 10:30:00,769566.72,770457.8200000003
Buy,188,4093.44,2021-10-24 10:30:00,769566.72,891.100000000326
Sell,188,4093.95,2021-10-24 10:45:00,769662.6,770553.7000000003
Buy,188,4093.95,2021-10-24 10:45:00,769662.6,891.100000000326
Sell,188,4081.74,2021-10-24 11:00:00,767367.12,768258.2200000003
Buy,188,4081.74,2021-10-24 11:00:00,767367.12,891.100000000326
Sell,188,4067.38,2021-10-24 11:15:00,764667.4400000001,765558.5400000004
Buy,188,4067.38,2021-10-24 11:15:00,764667.4400000001,891.100000000326
Sell,188,4036.73,2021-10-24 11:30:00,758905.24,759796.3400000003
Buy,188,4036.73,2021-10-24 11:30:00,758905.24,891.100000000326
Sell,188,4030.62,2021-10-24 11:45:00,757756.5599999999,758647.6600000003
Buy,188,4029.77,2021-10-24 12:00:00,757596.76,1050.9000000002561
Sell,188,4032.99,2021-10-24 12:15:00,758202.12,759253.0200000003
Buy,188,4035.37,2021-10-24 12:30:00,758649.5599999999,603.460000000312
Sell,188,4042.71,2021-10-24 12:45:00,760029.48,760632.9400000003
Buy,188,4042.71,2021-10-24 12:45:00,760029.48,603.460000000312
Sell,188,4048.76,2021-10-24 13:00:00,761166.88,761770.3400000003
Buy,188,4048.76,2021-10-24 13:00:00,761166.88,603.460000000312
Sell,188,4066.18,2021-10-24 13:15:00,764441.84,765045.3000000003
Buy,188,4066.18,2021-10-24 13:15:00,764441.84,603.460000000312
Sell,188,4055.13,2021-10-24 13:30:00,762364.4400000001,762967.9000000004
Buy,188,4055.13,2021-10-24 13:30:00,762364.4400000001,603.460000000312
Sell,188,4049.01,2021-10-24 13:45:00,761213.88,761817.3400000003
Buy,188,4049.01,2021-10-24 13:45:00,761213.88,603.460000000312
Sell,188,4047.99,2021-10-24 14:00:00,761022.12,761625.5800000003
Buy,188,4047.99,2021-10-24 14:00:00,761022.12,603.460000000312
Sell,188,4035.28,2021-10-24 14:15:00,758632.64,759236.1000000003
Buy,188,4035.28,2021-10-24 14:15:00,758632.64,603.460000000312
Sell,188,4025.63,2021-10-24 14:30:00,756818.4400000001,757421.9000000004
Buy,188,4025.63,2021-10-24 14:30:00,756818.4400000001,603.460000000312
Sell,188,4025.58,2021-10-24 14:45:00,756809.04,757412.5000000003
Buy,188,4025.58,2021-10-24 14:45:00,756809.04,603.460000000312
Sell,188,4024.69,2021-10-24 15:00:00,756641.72,757245.1800000003
Buy,188,4024.69,2021-10-24 15:00:00,756641.72,603.460000000312
Sell,188,3990.06,2021-10-24 15:15:00,750131.28,750734.7400000003
Buy,188,3990.06,2021-10-24 15:15:00,750131.28,603.460000000312
Sell,188,4018.77,2021-10-24 15:30:00,755528.76,756132.2200000003
Buy,188,4003.64,2021-10-24 15:45:00,752684.32,3447.9000000003725
Sell,188,3987.5,2021-10-24 16:00:00,749650.0,753097.9000000004
Buy,181,4153.57,2021-10-25 07:45:00,751796.1699999999,1301.730000000447
Sell,181,4164.25,2021-10-25 08:00:00,753729.25,755030.9800000004
Buy,182,4138.28,2021-10-25 11:30:00,753166.96,1864.0200000004843
Sell,182,4130.33,2021-10-25 11:45:00,751720.0599999999,753584.0800000004
Buy,181,4144.79,2021-10-25 13:30:00,750206.99,3377.090000000433
Sell,181,4162.82,2021-10-25 13:45:00,753470.4199999999,756847.5100000004
Buy,182,4152.79,2021-10-25 14:00:00,755807.78,1039.7300000003306
Sell,182,4144.92,2021-10-25 14:15:00,754375.4400000001,755415.1700000004
Buy,181,4151.63,2021-10-25 15:15:00,751445.03,3970.140000000363
Sell,181,4166.8,2021-10-25 15:30:00,754190.8,758160.9400000004
Buy,179,4216.39,2021-10-25 15:45:00,754733.81,3427.130000000354
Sell,179,4203.7,2021-10-25 16:00:00,752462.2999999999,755889.4300000003
Buy,179,4203.7,2021-10-25 16:00:00,752462.2999999999,3427.130000000354
Sell,179,4213.83,2021-10-25 16:15:00,754275.57,757702.7000000003
Buy,179,4213.83,2021-10-25 16:15:00,754275.57,3427.130000000354
Sell,179,4222.22,2021-10-25 16:30:00,755777.38,759204.5100000004
Buy,179,4222.22,2021-10-25 16:30:00,755777.38,3427.130000000354
Sell,179,4234.27,2021-10-25 16:45:00,757934.3300000001,761361.4600000004
Buy,179,4234.27,2021-10-25 16:45:00,757934.3300000001,3427.130000000354
Sell,179,4210.56,2021-10-25 17:00:00,753690.2400000001,757117.3700000005
Buy,179,4210.56,2021-10-25 17:00:00,753690.2400000001,3427.130000000354
Sell,179,4200.31,2021-10-25 17:15:00,751855.4900000001,755282.6200000005
Buy,179,4200.31,2021-10-25 17:15:00,751855.4900000001,3427.130000000354
Sell,179,4189.45,2021-10-25 17:30:00,749911.5499999999,753338.6800000003
Buy,179,4189.45,2021-10-25 17:30:00,749911.5499999999,3427.130000000354
Sell,179,4189.91,2021-10-25 17:45:00,749993.89,753421.0200000004
Buy,179,4189.91,2021-10-25 17:45:00,749993.89,3427.130000000354
Sell,179,4188.99,2021-10-25 18:00:00,749829.21,753256.3400000003
Buy,179,4188.99,2021-10-25 18:00:00,749829.21,3427.130000000354
Sell,179,4205.61,2021-10-25 18:15:00,752804.19,756231.3200000003
Buy,179,4205.61,2021-10-25 18:15:00,752804.19,3427.130000000354
Sell,179,4200.88,2021-10-25 18:30:00,751957.52,755384.6500000004
Buy,179,4200.88,2021-10-25 18:30:00,751957.52,3427.130000000354
Sell,179,4214.53,2021-10-25 18:45:00,754400.87,757828.0000000003
Buy,179,4214.53,2021-10-25 18:45:00,754400.87,3427.130000000354
Sell,179,4203.35,2021-10-25 19:00:00,752399.65,755826.7800000004
Buy,179,4203.35,2021-10-25 19:00:00,752399.65,3427.130000000354
Sell,179,4196.84,2021-10-25 19:15:00,751234.36,754661.4900000003
Buy,179,4196.84,2021-10-25 19:15:00,751234.36,3427.130000000354
Sell,179,4189.49,2021-10-25 19:30:00,749918.71,753345.8400000003
Buy,179,4189.49,2021-10-25 19:30:00,749918.71,3427.130000000354
Sell,179,4189.11,2021-10-25 19:45:00,749850.69,753277.8200000003
Buy,179,4189.11,2021-10-25 19:45:00,749850.69,3427.130000000354
Sell,179,4202.4,2021-10-25 20:00:00,752229.6,755656.7300000003
Buy,179,4202.4,2021-10-25 20:00:00,752229.6,3427.130000000354
Sell,179,4194.88,2021-10-25 20:15:00,750883.52,754310.6500000004
Buy,179,4194.88,2021-10-25 20:15:00,750883.52,3427.130000000354
Sell,179,4191.54,2021-10-25 20:30:00,750285.66,753712.7900000004
Buy,179,4191.54,2021-10-25 20:30:00,750285.66,3427.130000000354
Sell,179,4184.74,2021-10-25 20:45:00,749068.46,752495.5900000003
Buy,179,4184.74,2021-10-25 20:45:00,749068.46,3427.130000000354
Sell,179,4199.16,2021-10-25 21:00:00,751649.64,755076.7700000004
Buy,179,4199.16,2021-10-25 21:00:00,751649.64,3427.130000000354
Sell,179,4193.88,2021-10-25 21:15:00,750704.52,754131.6500000004
Buy,179,4193.88,2021-10-25 21:15:00,750704.52,3427.130000000354
Sell,179,4203.25,2021-10-25 21:30:00,752381.75,755808.8800000004
Buy,179,4203.25,2021-10-25 21:30:00,752381.75,3427.130000000354
Sell,179,4194.66,2021-10-25 21:45:00,750844.14,754271.2700000004
Buy,179,4194.66,2021-10-25 21:45:00,750844.14,3427.130000000354
Sell,179,4201.62,2021-10-25 22:00:00,752089.98,755517.1100000003
Buy,179,4201.62,2021-10-25 22:00:00,752089.98,3427.130000000354
Sell,179,4214.5,2021-10-25 22:15:00,754395.5,757822.6300000004
Buy,179,4214.5,2021-10-25 22:15:00,754395.5,3427.130000000354
Sell,179,4220.5,2021-10-25 22:30:00,755469.5,758896.6300000004
Buy,179,4220.5,2021-10-25 22:30:00,755469.5,3427.130000000354
Sell,179,4224.0,2021-10-25 22:45:00,756096.0,759523.1300000004
Buy,179,4224.0,2021-10-25 22:45:00,756096.0,3427.130000000354
Sell,179,4224.25,2021-10-25 23:00:00,756140.75,759567.8800000004
Buy,179,4224.25,2021-10-25 23:00:00,756140.75,3427.130000000354
Sell,179,4214.53,2021-10-25 23:15:00,754400.87,757828.0000000003
Buy,179,4214.53,2021-10-25 23:15:00,754400.87,3427.130000000354
Sell,179,4216.81,2021-10-25 23:30:00,754808.9900000001,758236.1200000005
Buy,179,4216.81,2021-10-25 23:30:00,754808.9900000001,3427.130000000354
Sell,179,4224.14,2021-10-25 23:45:00,756121.06,759548.1900000004
Buy,179,4224.14,2021-10-25 23:45:00,756121.06,3427.130000000354
Sell,179,4218.38,2021-10-26 00:00:00,755090.02,758517.1500000004
Buy,179,4218.38,2021-10-26 00:00:00,755090.02,3427.130000000354
Sell,179,4263.57,2021-10-26 00:15:00,763179.0299999999,766606.1600000003
Buy,179,4263.57,2021-10-26 00:15:00,763179.0299999999,3427.130000000354
Sell,179,4241.34,2021-10-26 00:30:00,759199.86,762626.9900000003
Buy,179,4241.34,2021-10-26 00:30:00,759199.86,3427.130000000354
Sell,179,4245.55,2021-10-26 00:45:00,759953.4500000001,763380.5800000004
Buy,179,4245.55,2021-10-26 00:45:00,759953.4500000001,3427.130000000354
Sell,179,4229.32,2021-10-26 01:00:00,757048.2799999999,760475.4100000003
Buy,179,4229.32,2021-10-26 01:00:00,757048.2799999999,3427.130000000354
Sell,179,4229.23,2021-10-26 01:15:00,757032.1699999999,760459.3000000003
Buy,179,4229.23,2021-10-26 01:15:00,757032.1699999999,3427.130000000354
Sell,179,4225.39,2021-10-26 01:30:00,756344.81,759771.9400000004
Buy,179,4225.39,2021-10-26 01:30:00,756344.81,3427.130000000354
Sell,179,4223.05,2021-10-26 01:45:00,755925.9500000001,759353.0800000004
Buy,179,4223.05,2021-10-26 01:45:00,755925.9500000001,3427.130000000354
Sell,179,4232.6,2021-10-26 02:00:00,757635.4,761062.5300000004
Buy,179,4232.6,2021-10-26 02:00:00,757635.4,3427.130000000354
Sell,179,4246.54,2021-10-26 02:15:00,760130.66,763557.7900000004
Buy,179,4246.54,2021-10-26 02:15:00,760130.66,3427.130000000354
Sell,179,4240.72,2021-10-26 02:30:00,759088.88,762516.0100000004
Buy,179,4240.72,2021-10-26 02:30:00,759088.88,3427.130000000354
Sell,179,4237.98,2021-10-26 02:45:00,758598.4199999999,762025.5500000003
Buy,179,4237.98,2021-10-26 02:45:00,758598.4199999999,3427.130000000354
Sell,179,4244.8,2021-10-26 03:00:00,759819.2000000001,763246.3300000004
Buy,179,4244.8,2021-10-26 03:00:00,759819.2000000001,3427.130000000354
Sell,179,4233.11,2021-10-26 03:15:00,757726.69,761153.8200000003
Buy,179,4233.11,2021-10-26 03:15:00,757726.69,3427.130000000354
Sell,179,4229.78,2021-10-26 03:30:00,757130.62,760557.7500000003
Buy,179,4229.78,2021-10-26 03:30:00,757130.62,3427.130000000354
Sell,179,4228.41,2021-10-26 03:45:00,756885.39,760312.5200000004
Buy,179,4228.41,2021-10-26 03:45:00,756885.39,3427.130000000354
Sell,179,4223.32,2021-10-26 04:00:00,755974.2799999999,759401.4100000003
Buy,179,4223.32,2021-10-26 04:00:00,755974.2799999999,3427.130000000354
Sell,179,4211.97,2021-10-26 04:15:00,753942.63,757369.7600000004
Buy,179,4211.97,2021-10-26 04:15:00,753942.63,3427.130000000354
Sell,179,4209.1,2021-10-26 04:30:00,753428.9,756856.0300000004
Buy,179,4209.1,2021-10-26 04:30:00,753428.9,3427.130000000354
Sell,179,4210.37,2021-10-26 04:45:00,753656.23,757083.3600000003
Buy,179,4210.37,2021-10-26 04:45:00,753656.23,3427.130000000354
Sell,179,4214.07,2021-10-26 05:00:00,754318.5299999999,757745.6600000003
Buy,179,4214.07,2021-10-26 05:00:00,754318.5299999999,3427.130000000354
Sell,179,4213.63,2021-10-26 05:15:00,754239.77,757666.9000000004
Buy,179,4213.63,2021-10-26 05:15:00,754239.77,3427.130000000354
Sell,179,4208.37,2021-10-26 05:30:00,753298.23,756725.3600000003
Buy,179,4208.37,2021-10-26 05:30:00,753298.23,3427.130000000354
Sell,179,4203.73,2021-10-26 05:45:00,752467.6699999999,755894.8000000003
Buy,179,4203.73,2021-10-26 05:45:00,752467.6699999999,3427.130000000354
Sell,179,4196.54,2021-10-26 06:00:00,751180.66,754607.7900000004
Buy,179,4196.54,2021-10-26 06:00:00,751180.66,3427.130000000354
Sell,179,4205.85,2021-10-26 06:15:00,752847.15,756274.2800000004
Buy,179,4205.85,2021-10-26 06:15:00,752847.15,3427.130000000354
Sell,179,4205.71,2021-10-26 06:30:00,752822.09,756249.2200000003
Buy,179,4205.71,2021-10-26 06:30:00,752822.09,3427.130000000354
Sell,179,4194.15,2021-10-26 06:45:00,750752.85,754179.9800000003
Buy,179,4194.15,2021-10-26 06:45:00,750752.85,3427.130000000354
Sell,179,4187.14,2021-10-26 07:00:00,749498.06,752925.1900000004
Buy,179,4187.14,2021-10-26 07:00:00,749498.06,3427.130000000354
Sell,179,4188.79,2021-10-26 07:15:00,749793.41,753220.5400000004
Buy,179,4188.79,2021-10-26 07:15:00,749793.41,3427.130000000354
Sell,179,4197.39,2021-10-26 07:30:00,751332.81,754759.9400000004
Buy,179,4197.39,2021-10-26 07:30:00,751332.81,3427.130000000354
Sell,179,4201.19,2021-10-26 07:45:00,752013.0099999999,755440.1400000002
Buy,179,4201.19,2021-10-26 07:45:00,752013.0099999999,3427.130000000354
Sell,179,4226.04,2021-10-26 08:00:00,756461.16,759888.2900000004
Buy,179,4226.04,2021-10-26 08:00:00,756461.16,3427.130000000354
Sell,179,4228.49,2021-10-26 08:15:00,756899.71,760326.8400000003
Buy,179,4228.49,2021-10-26 08:15:00,756899.71,3427.130000000354
Sell,179,4219.69,2021-10-26 08:30:00,755324.5099999999,758751.6400000002
Buy,179,4219.69,2021-10-26 08:30:00,755324.5099999999,3427.130000000354
Sell,179,4218.07,2021-10-26 08:45:00,755034.5299999999,758461.6600000003
Buy,179,4218.07,2021-10-26 08:45:00,755034.5299999999,3427.130000000354
Sell,179,4209.48,2021-10-26 09:00:00,753496.9199999999,756924.0500000003
Buy,179,4209.48,2021-10-26 09:00:00,753496.9199999999,3427.130000000354
Sell,179,4219.96,2021-10-26 09:15:00,755372.84,758799.9700000003
Buy,179,4219.96,2021-10-26 09:15:00,755372.84,3427.130000000354
Sell,179,4212.58,2021-10-26 09:30:00,754051.82,757478.9500000003
Buy,179,4212.58,2021-10-26 09:30:00,754051.82,3427.130000000354
Sell,179,4212.48,2021-10-26 09:45:00,754033.9199999999,757461.0500000003
Buy,179,4212.48,2021-10-26 09:45:00,754033.9199999999,3427.130000000354
Sell,179,4201.02,2021-10-26 10:00:00,751982.5800000001,755409.7100000004
Buy,179,4201.02,2021-10-26 10:00:00,751982.5800000001,3427.130000000354
Sell,179,4215.86,2021-10-26 10:15:00,754638.94,758066.0700000003
Buy,179,4215.86,2021-10-26 10:15:00,754638.94,3427.130000000354
Sell,179,4213.69,2021-10-26 10:30:00,754250.5099999999,757677.6400000002
Buy,179,4213.69,2021-10-26 10:30:00,754250.5099999999,3427.130000000354
Sell,179,4231.41,2021-10-26 10:45:00,757422.39,760849.5200000004
Buy,179,4231.41,2021-10-26 10:45:00,757422.39,3427.130000000354
Sell,179,4222.52,2021-10-26 11:00:00,755831.0800000001,759258.2100000004
Buy,179,4222.52,2021-10-26 11:00:00,755831.0800000001,3427.130000000354
Sell,179,4214.0,2021-10-26 11:15:00,754306.0,757733.1300000004
Buy,179,4214.0,2021-10-26 11:15:00,754306.0,3427.130000000354
Sell,179,4211.59,2021-10-26 11:30:00,753874.61,757301.7400000003
Buy,179,4211.59,2021-10-26 11:30:00,753874.61,3427.130000000354
Sell,179,4220.04,2021-10-26 11:45:00,755387.16,758814.2900000004
Buy,179,4220.04,2021-10-26 11:45:00,755387.16,3427.130000000354
Sell,179,4212.8,2021-10-26 12:00:00,754091.2000000001,757518.3300000004
Buy,179,4212.8,2021-10-26 12:00:00,754091.2000000001,3427.130000000354
Sell,179,4199.17,2021-10-26 12:15:00,751651.43,755078.5600000004
Buy,179,4199.17,2021-10-26 12:15:00,751651.43,3427.130000000354
Sell,179,4192.47,2021-10-26 12:30:00,750452.13,753879.2600000004
Buy,179,4192.47,2021-10-26 12:30:00,750452.13,3427.130000000354
Sell,179,4195.23,2021-10-26 12:45:00,750946.1699999999,754373.3000000003
Buy,179,4195.23,2021-10-26 12:45:00,750946.1699999999,3427.130000000354
Sell,179,4195.59,2021-10-26 13:00:00,751010.61,754437.7400000003
Buy,179,4195.59,2021-10-26 13:00:00,751010.61,3427.130000000354
Sell,179,4202.08,2021-10-26 13:15:00,752172.32,755599.4500000003
Buy,179,4202.08,2021-10-26 13:15:00,752172.32,3427.130000000354
Sell,179,4202.05,2021-10-26 13:30:00,752166.9500000001,755594.0800000004
Buy,179,4202.05,2021-10-26 13:30:00,752166.9500000001,3427.130000000354
Sell,179,4190.38,2021-10-26 13:45:00,750078.02,753505.1500000004
Buy,179,4190.38,2021-10-26 13:45:00,750078.02,3427.130000000354
Sell,179,4159.13,2021-10-26 14:00:00,744484.27,747911.4000000004
Buy,178,4189.47,2021-10-26 15:45:00,745725.66,2185.74000000034
Sell,178,4180.89,2021-10-26 16:00:00,744198.42,746384.1600000004
Buy,177,4207.62,2021-10-26 17:30:00,744748.74,1635.4200000003912
Sell,177,4220.33,2021-10-26 17:45:00,746998.41,748633.8300000004
Buy,177,4220.33,2021-10-26 17:45:00,746998.41,1635.4200000003912
Sell,177,4230.11,2021-10-26 18:00:00,748729.47,750364.8900000004
Buy,177,4230.11,2021-10-26 18:00:00,748729.47,1635.4200000003912
Sell,177,4221.14,2021-10-26 18:15:00,747141.78,748777.2000000004
Buy,177,4221.14,2021-10-26 18:15:00,747141.78,1635.4200000003912
Sell,177,4211.42,2021-10-26 18:30:00,745421.34,747056.7600000004
Buy,177,4211.42,2021-10-26 18:30:00,745421.34,1635.4200000003912
Sell,177,4213.85,2021-10-26 18:45:00,745851.4500000001,747486.8700000005
Buy,177,4213.85,2021-10-26 18:45:00,745851.4500000001,1635.4200000003912
Sell,177,4223.08,2021-10-26 19:00:00,747485.16,749120.5800000004
Buy,177,4223.08,2021-10-26 19:00:00,747485.16,1635.4200000003912
Sell,177,4219.39,2021-10-26 19:15:00,746832.03,748467.4500000004
Buy,177,4219.39,2021-10-26 19:15:00,746832.03,1635.4200000003912
Sell,177,4223.51,2021-10-26 19:30:00,747561.27,749196.6900000004
Buy,177,4223.51,2021-10-26 19:30:00,747561.27,1635.4200000003912
Sell,177,4214.87,2021-10-26 19:45:00,746031.99,747667.4100000004
Buy,177,4214.87,2021-10-26 19:45:00,746031.99,1635.4200000003912
Sell,177,4249.57,2021-10-26 20:00:00,752173.8899999999,753809.3100000003
Buy,177,4249.57,2021-10-26 20:00:00,752173.8899999999,1635.4200000003912
Sell,177,4296.04,2021-10-26 20:15:00,760399.08,762034.5000000003
Buy,177,4296.04,2021-10-26 20:15:00,760399.08,1635.4200000003912
Sell,177,4259.68,2021-10-26 20:30:00,753963.3600000001,755598.7800000005
Buy,177,4259.68,2021-10-26 20:30:00,753963.3600000001,1635.4200000003912
Sell,177,4270.15,2021-10-26 20:45:00,755816.5499999999,757451.9700000003
Buy,177,4270.15,2021-10-26 20:45:00,755816.5499999999,1635.4200000003912
Sell,177,4274.86,2021-10-26 21:00:00,756650.22,758285.6400000004
Buy,177,4274.86,2021-10-26 21:00:00,756650.22,1635.4200000003912
Sell,177,4265.63,2021-10-26 21:15:00,755016.51,756651.9300000004
Buy,177,4265.63,2021-10-26 21:15:00,755016.51,1635.4200000003912
Sell,177,4249.91,2021-10-26 21:30:00,752234.07,753869.4900000003
Buy,177,4249.91,2021-10-26 21:30:00,752234.07,1635.4200000003912
Sell,177,4207.17,2021-10-26 21:45:00,744669.09,746304.5100000004
Buy,177,4207.17,2021-10-26 21:45:00,744669.09,1635.4200000003912
Sell,177,4196.23,2021-10-26 22:00:00,742732.71,744368.1300000004
Buy,177,4196.23,2021-10-26 22:00:00,742732.71,1635.4200000003912
Sell,177,4187.25,2021-10-26 22:15:00,741143.25,742778.6700000004
Buy,177,4187.25,2021-10-26 22:15:00,741143.25,1635.4200000003912
Sell,177,4137.65,2021-10-26 22:30:00,732364.0499999999,733999.4700000003
Buy,177,4137.65,2021-10-26 22:30:00,732364.0499999999,1635.4200000003912
Sell,177,4123.75,2021-10-26 22:45:00,729903.75,731539.1700000004
Buy,177,4123.75,2021-10-26 22:45:00,729903.75,1635.4200000003912
Sell,177,4140.31,2021-10-26 23:00:00,732834.8700000001,734470.2900000005
Buy,177,4140.31,2021-10-26 23:00:00,732834.8700000001,1635.4200000003912
Sell,177,4128.83,2021-10-26 23:15:00,730802.91,732438.3300000004
Buy,177,4128.83,2021-10-26 23:15:00,730802.91,1635.4200000003912
Sell,177,4134.9,2021-10-26 23:30:00,731877.2999999999,733512.7200000003
Buy,177,4134.9,2021-10-26 23:30:00,731877.2999999999,1635.4200000003912
Sell,177,4133.39,2021-10-26 23:45:00,731610.03,733245.4500000004
Buy,177,4133.39,2021-10-26 23:45:00,731610.03,1635.4200000003912
Sell,177,4134.76,2021-10-27 00:00:00,731852.52,733487.9400000004
Buy,177,4134.76,2021-10-27 00:00:00,731852.52,1635.4200000003912
Sell,177,4164.76,2021-10-27 00:15:00,737162.52,738797.9400000004
Buy,177,4164.76,2021-10-27 00:15:00,737162.52,1635.4200000003912
Sell,177,4148.71,2021-10-27 00:30:00,734321.67,735957.0900000004
Buy,177,4148.71,2021-10-27 00:30:00,734321.67,1635.4200000003912
Sell,177,4160.33,2021-10-27 00:45:00,736378.41,738013.8300000004
Buy,177,4160.33,2021-10-27 00:45:00,736378.41,1635.4200000003912
Sell,177,4162.66,2021-10-27 01:00:00,736790.82,738426.2400000003
Buy,177,4162.66,2021-10-27 01:00:00,736790.82,1635.4200000003912
Sell,177,4177.92,2021-10-27 01:15:00,739491.84,741127.2600000004
Buy,177,4177.92,2021-10-27 01:15:00,739491.84,1635.4200000003912
Sell,177,4167.08,2021-10-27 01:30:00,737573.16,739208.5800000004
Buy,177,4167.08,2021-10-27 01:30:00,737573.16,1635.4200000003912
Sell,177,4151.13,2021-10-27 01:45:00,734750.01,736385.4300000004
Buy,177,4151.13,2021-10-27 01:45:00,734750.01,1635.4200000003912
Sell,177,4165.54,2021-10-27 02:00:00,737300.58,738936.0000000003
Buy,177,4165.54,2021-10-27 02:00:00,737300.58,1635.4200000003912
Sell,177,4174.16,2021-10-27 02:15:00,738826.32,740461.7400000003
Buy,177,4174.16,2021-10-27 02:15:00,738826.32,1635.4200000003912
Sell,177,4175.22,2021-10-27 02:30:00,739013.9400000001,740649.3600000005
Buy,177,4175.22,2021-10-27 02:30:00,739013.9400000001,1635.4200000003912
Sell,177,4184.31,2021-10-27 02:45:00,740622.8700000001,742258.2900000005
Buy,177,4184.31,2021-10-27 02:45:00,740622.8700000001,1635.4200000003912
Sell,177,4201.39,2021-10-27 03:00:00,743646.03,745281.4500000004
Buy,177,4201.39,2021-10-27 03:00:00,743646.03,1635.4200000003912
Sell,177,4230.54,2021-10-27 03:15:00,748805.58,750441.0000000003
Buy,177,4230.54,2021-10-27 03:15:00,748805.58,1635.4200000003912
Sell,177,4212.31,2021-10-27 03:30:00,745578.8700000001,747214.2900000005
Buy,177,4212.31,2021-10-27 03:30:00,745578.8700000001,1635.4200000003912
Sell,177,4214.29,2021-10-27 03:45:00,745929.33,747564.7500000003
Buy,177,4214.29,2021-10-27 03:45:00,745929.33,1635.4200000003912
Sell,177,4219.47,2021-10-27 04:00:00,746846.1900000001,748481.6100000005
Buy,177,4219.47,2021-10-27 04:00:00,746846.1900000001,1635.4200000003912
Sell,177,4281.83,2021-10-27 04:15:00,757883.91,759519.3300000004
Buy,177,4281.83,2021-10-27 04:15:00,757883.91,1635.4200000003912
Sell,177,4289.34,2021-10-27 04:30:00,759213.18,760848.6000000004
Buy,177,4289.34,2021-10-27 04:30:00,759213.18,1635.4200000003912
Sell,177,4287.14,2021-10-27 04:45:00,758823.78,760459.2000000004
Buy,177,4287.14,2021-10-27 04:45:00,758823.78,1635.4200000003912
Sell,177,4296.07,2021-10-27 05:00:00,760404.3899999999,762039.8100000003
Buy,177,4296.07,2021-10-27 05:00:00,760404.3899999999,1635.4200000003912
Sell,177,4283.56,2021-10-27 05:15:00,758190.1200000001,759825.5400000005
Buy,177,4283.56,2021-10-27 05:15:00,758190.1200000001,1635.4200000003912
Sell,177,4277.38,2021-10-27 05:30:00,757096.26,758731.6800000004
Buy,177,4277.38,2021-10-27 05:30:00,757096.26,1635.4200000003912
Sell,177,4277.67,2021-10-27 05:45:00,757147.59,758783.0100000004
Buy,177,4277.67,2021-10-27 05:45:00,757147.59,1635.4200000003912
Sell,177,4265.04,2021-10-27 06:00:00,754912.08,756547.5000000003
Buy,177,4265.04,2021-10-27 06:00:00,754912.08,1635.4200000003912
Sell,177,4259.48,2021-10-27 06:15:00,753927.96,755563.3800000004
Buy,177,4259.48,2021-10-27 06:15:00,753927.96,1635.4200000003912
Sell,177,4243.01,2021-10-27 06:30:00,751012.77,752648.1900000004
Buy,177,4243.01,2021-10-27 06:30:00,751012.77,1635.4200000003912
Sell,177,4245.01,2021-10-27 06:45:00,751366.77,753002.1900000004
Buy,177,4245.01,2021-10-27 06:45:00,751366.77,1635.4200000003912
Sell,177,4232.91,2021-10-27 07:00:00,749225.07,750860.4900000003
Buy,177,4232.91,2021-10-27 07:00:00,749225.07,1635.4200000003912
Sell,177,4209.23,2021-10-27 07:15:00,745033.71,746669.1300000004
Buy,177,4209.23,2021-10-27 07:15:00,745033.71,1635.4200000003912
Sell,177,4164.41,2021-10-27 07:30:00,737100.57,738735.9900000003
Buy,177,4164.41,2021-10-27 07:30:00,737100.57,1635.4200000003912
Sell,177,4139.76,2021-10-27 07:45:00,732737.52,734372.9400000004
Buy,177,4139.76,2021-10-27 07:45:00,732737.52,1635.4200000003912
Sell,177,4039.02,2021-10-27 08:00:00,714906.54,716541.9600000004
Buy,177,4039.02,2021-10-27 08:00:00,714906.54,1635.4200000003912
Sell,177,4047.24,2021-10-27 08:15:00,716361.48,717996.9000000004
Buy,177,4047.24,2021-10-27 08:15:00,716361.48,1635.4200000003912
Sell,177,4035.5,2021-10-27 08:30:00,714283.5,715918.9200000004
Buy,177,4035.5,2021-10-27 08:30:00,714283.5,1635.4200000003912
Sell,177,4049.66,2021-10-27 08:45:00,716789.82,718425.2400000003
Buy,177,4049.66,2021-10-27 08:45:00,716789.82,1635.4200000003912
Sell,177,4015.93,2021-10-27 09:00:00,710819.61,712455.0300000004
Buy,177,4015.93,2021-10-27 09:00:00,710819.61,1635.4200000003912
Sell,177,3996.14,2021-10-27 09:15:00,707316.78,708952.2000000004
Buy,177,3996.14,2021-10-27 09:15:00,707316.78,1635.4200000003912
Sell,177,4021.72,2021-10-27 09:30:00,711844.44,713479.8600000003
Buy,177,4021.72,2021-10-27 09:30:00,711844.44,1635.4200000003912
Sell,177,4020.0,2021-10-27 09:45:00,711540.0,713175.4200000004
Buy,177,4020.0,2021-10-27 09:45:00,711540.0,1635.4200000003912
Sell,177,4009.99,2021-10-27 10:00:00,709768.23,711403.6500000004
Buy,177,4009.99,2021-10-27 10:00:00,709768.23,1635.4200000003912
Sell,177,3978.82,2021-10-27 10:15:00,704251.14,705886.5600000004
Buy,177,3978.82,2021-10-27 10:15:00,704251.14,1635.4200000003912
Sell,177,4018.64,2021-10-27 10:30:00,711299.28,712934.7000000004
Buy,177,4018.64,2021-10-27 10:30:00,711299.28,1635.4200000003912
Sell,177,4024.54,2021-10-27 10:45:00,712343.58,713979.0000000003
Buy,177,4024.54,2021-10-27 10:45:00,712343.58,1635.4200000003912
Sell,177,4046.93,2021-10-27 11:00:00,716306.61,717942.0300000004
Buy,177,4046.93,2021-10-27 11:00:00,716306.61,1635.4200000003912
Sell,177,4021.26,2021-10-27 11:15:00,711763.02,713398.4400000004
Buy,177,4021.26,2021-10-27 11:15:00,711763.02,1635.4200000003912
Sell,177,4006.12,2021-10-27 11:30:00,709083.24,710718.6600000004
Buy,177,4006.12,2021-10-27 11:30:00,709083.24,1635.4200000003912
Sell,177,3995.01,2021-10-27 11:45:00,707116.77,708752.1900000004
Buy,177,3995.01,2021-10-27 11:45:00,707116.77,1635.4200000003912
Sell,177,3995.07,2021-10-27 12:00:00,707127.39,708762.8100000004
Buy,177,3995.07,2021-10-27 12:00:00,707127.39,1635.4200000003912
Sell,177,4018.7,2021-10-27 12:15:00,711309.9,712945.3200000004
Buy,177,4018.7,2021-10-27 12:15:00,711309.9,1635.4200000003912
Sell,177,4005.25,2021-10-27 12:30:00,708929.25,710564.6700000004
Buy,177,4005.25,2021-10-27 12:30:00,708929.25,1635.4200000003912
Sell,177,4014.36,2021-10-27 12:45:00,710541.72,712177.1400000004
Buy,177,4014.36,2021-10-27 12:45:00,710541.72,1635.4200000003912
Sell,177,4027.2,2021-10-27 13:00:00,712814.4,714449.8200000004
Buy,177,4027.2,2021-10-27 13:00:00,712814.4,1635.4200000003912
Sell,177,3998.69,2021-10-27 13:15:00,707768.13,709403.5500000004
Buy,177,3998.69,2021-10-27 13:15:00,707768.13,1635.4200000003912
Sell,177,4024.45,2021-10-27 13:30:00,712327.65,713963.0700000004
Buy,177,4024.45,2021-10-27 13:30:00,712327.65,1635.4200000003912
Sell,177,3997.39,2021-10-27 13:45:00,707538.03,709173.4500000004
Buy,177,3997.39,2021-10-27 13:45:00,707538.03,1635.4200000003912
Sell,177,3986.79,2021-10-27 14:00:00,705661.83,707297.2500000003
Buy,177,3986.79,2021-10-27 14:00:00,705661.83,1635.4200000003912
Sell,177,3990.51,2021-10-27 14:15:00,706320.27,707955.6900000004
Buy,177,3990.51,2021-10-27 14:15:00,706320.27,1635.4200000003912
Sell,177,4017.4,2021-10-27 14:30:00,711079.8,712715.2200000004
Buy,177,4017.4,2021-10-27 14:30:00,711079.8,1635.4200000003912
Sell,177,4016.76,2021-10-27 14:45:00,710966.52,712601.9400000004
Buy,177,4016.76,2021-10-27 14:45:00,710966.52,1635.4200000003912
Sell,177,4037.55,2021-10-27 15:00:00,714646.35,716281.7700000004
Buy,177,4037.55,2021-10-27 15:00:00,714646.35,1635.4200000003912
Sell,177,3998.88,2021-10-27 15:15:00,707801.76,709437.1800000004
Buy,177,3998.88,2021-10-27 15:15:00,707801.76,1635.4200000003912
Sell,177,3989.54,2021-10-27 15:30:00,706148.58,707784.0000000003
Buy,177,3989.54,2021-10-27 15:30:00,706148.58,1635.4200000003912
Sell,177,3995.51,2021-10-27 15:45:00,707205.27,708840.6900000004
Buy,177,3995.51,2021-10-27 15:45:00,707205.27,1635.4200000003912
Sell,177,3980.13,2021-10-27 16:00:00,704483.01,706118.4300000004
Buy,177,3980.13,2021-10-27 16:00:00,704483.01,1635.4200000003912
Sell,177,3955.51,2021-10-27 16:15:00,700125.27,701760.6900000004
Buy,177,3955.51,2021-10-27 16:15:00,700125.27,1635.4200000003912
Sell,177,3991.78,2021-10-27 16:30:00,706545.06,708180.4800000004
Buy,177,3991.78,2021-10-27 16:30:00,706545.06,1635.4200000003912
Sell,177,3980.83,2021-10-27 16:45:00,704606.91,706242.3300000004
Buy,177,3980.83,2021-10-27 16:45:00,704606.91,1635.4200000003912
Sell,177,3997.97,2021-10-27 17:00:00,707640.69,709276.1100000003
Buy,177,3997.97,2021-10-27 17:00:00,707640.69,1635.4200000003912
Sell,177,3997.13,2021-10-27 17:15:00,707492.01,709127.4300000004
Buy,177,3997.13,2021-10-27 17:15:00,707492.01,1635.4200000003912
Sell,177,3987.37,2021-10-27 17:30:00,705764.49,707399.9100000004
Buy,177,3987.37,2021-10-27 17:30:00,705764.49,1635.4200000003912
Sell,177,3988.33,2021-10-27 17:45:00,705934.41,707569.8300000004
Buy,177,3988.33,2021-10-27 17:45:00,705934.41,1635.4200000003912
Sell,177,3987.92,2021-10-27 18:00:00,705861.84,707497.2600000004
Buy,177,3987.92,2021-10-27 18:00:00,705861.84,1635.4200000003912
Sell,177,3999.11,2021-10-27 18:15:00,707842.47,709477.8900000004
Buy,177,3999.11,2021-10-27 18:15:00,707842.47,1635.4200000003912
Sell,177,3986.86,2021-10-27 18:30:00,705674.22,707309.6400000004
Buy,177,3986.86,2021-10-27 18:30:00,705674.22,1635.4200000003912
Sell,177,3971.38,2021-10-27 18:45:00,702934.26,704569.6800000004
Buy,177,3971.38,2021-10-27 18:45:00,702934.26,1635.4200000003912
Sell,177,3952.46,2021-10-27 19:00:00,699585.42,701220.8400000004
Buy,177,3952.46,2021-10-27 19:00:00,699585.42,1635.4200000003912
Sell,177,3963.94,2021-10-27 19:15:00,701617.38,703252.8000000004
Buy,177,3963.94,2021-10-27 19:15:00,701617.38,1635.4200000003912
Sell,177,3959.75,2021-10-27 19:30:00,700875.75,702511.1700000004
Buy,177,3959.75,2021-10-27 19:30:00,700875.75,1635.4200000003912
Sell,177,4002.03,2021-10-27 19:45:00,708359.31,709994.7300000004
Buy,177,4002.03,2021-10-27 19:45:00,708359.31,1635.4200000003912
Sell,177,3982.36,2021-10-27 20:00:00,704877.72,706513.1400000004
Buy,177,3982.36,2021-10-27 20:00:00,704877.72,1635.4200000003912
Sell,177,3978.32,2021-10-27 20:15:00,704162.64,705798.0600000004
Buy,177,3978.32,2021-10-27 20:15:00,704162.64,1635.4200000003912
Sell,177,3965.46,2021-10-27 20:30:00,701886.42,703521.8400000004
Buy,177,3965.46,2021-10-27 20:30:00,701886.42,1635.4200000003912
Sell,177,3984.5,2021-10-27 20:45:00,705256.5,706891.9200000004
Buy,177,3984.5,2021-10-27 20:45:00,705256.5,1635.4200000003912
Sell,177,3994.12,2021-10-27 21:00:00,706959.24,708594.6600000004
Buy,177,3994.12,2021-10-27 21:00:00,706959.24,1635.4200000003912
Sell,177,3988.01,2021-10-27 21:15:00,705877.77,707513.1900000004
Buy,177,3988.01,2021-10-27 21:15:00,705877.77,1635.4200000003912
Sell,177,4005.09,2021-10-27 21:30:00,708900.93,710536.3500000004
Buy,177,4005.09,2021-10-27 21:30:00,708900.93,1635.4200000003912
Sell,177,3994.8,2021-10-27 21:45:00,707079.6,708715.0200000004
Buy,177,3994.8,2021-10-27 21:45:00,707079.6,1635.4200000003912
Sell,177,3977.72,2021-10-27 22:00:00,704056.44,705691.8600000003
Buy,177,3977.72,2021-10-27 22:00:00,704056.44,1635.4200000003912
Sell,177,3986.88,2021-10-27 22:15:00,705677.76,707313.1800000004
Buy,177,3986.88,2021-10-27 22:15:00,705677.76,1635.4200000003912
Sell,177,3971.54,2021-10-27 22:30:00,702962.58,704598.0000000003
Buy,177,3971.54,2021-10-27 22:30:00,702962.58,1635.4200000003912
Sell,177,3977.19,2021-10-27 22:45:00,703962.63,705598.0500000004
Buy,177,3977.19,2021-10-27 22:45:00,703962.63,1635.4200000003912
Sell,177,3975.28,2021-10-27 23:00:00,703624.56,705259.9800000004
Buy,177,3975.28,2021-10-27 23:00:00,703624.56,1635.4200000003912
Sell,177,3954.55,2021-10-27 23:15:00,699955.35,701590.7700000004
Buy,177,3954.55,2021-10-27 23:15:00,699955.35,1635.4200000003912
Sell,177,3946.8,2021-10-27 23:30:00,698583.6,700219.0200000004
Buy,177,3946.8,2021-10-27 23:30:00,698583.6,1635.4200000003912
Sell,177,3923.57,2021-10-27 23:45:00,694471.89,696107.3100000004
Buy,177,3923.57,2021-10-27 23:45:00,694471.89,1635.4200000003912
Sell,177,3955.77,2021-10-28 00:00:00,700171.29,701806.7100000004
Buy,177,3955.77,2021-10-28 00:00:00,700171.29,1635.4200000003912
Sell,177,3946.54,2021-10-28 00:15:00,698537.58,700173.0000000003
Buy,177,3946.54,2021-10-28 00:15:00,698537.58,1635.4200000003912
Sell,177,3940.49,2021-10-28 00:30:00,697466.73,699102.1500000004
Buy,177,3940.49,2021-10-28 00:30:00,697466.73,1635.4200000003912
Sell,177,3913.7,2021-10-28 00:45:00,692724.9,694360.3200000004
Buy,177,3913.7,2021-10-28 00:45:00,692724.9,1635.4200000003912
Sell,177,3950.81,2021-10-28 01:00:00,699293.37,700928.7900000004
Buy,177,3950.81,2021-10-28 01:00:00,699293.37,1635.4200000003912
Sell,177,3963.08,2021-10-28 01:15:00,701465.16,703100.5800000004
Buy,177,3963.08,2021-10-28 01:15:00,701465.16,1635.4200000003912
Sell,177,3986.3,2021-10-28 01:30:00,705575.1,707210.5200000004
Buy,177,3986.3,2021-10-28 01:30:00,705575.1,1635.4200000003912
Sell,177,3996.96,2021-10-28 01:45:00,707461.92,709097.3400000004
Buy,177,3996.96,2021-10-28 01:45:00,707461.92,1635.4200000003912
Sell,177,3980.65,2021-10-28 02:00:00,704575.05,706210.4700000004
Buy,177,3980.65,2021-10-28 02:00:00,704575.05,1635.4200000003912
Sell,177,3975.81,2021-10-28 02:15:00,703718.37,705353.7900000004
Buy,177,3975.81,2021-10-28 02:15:00,703718.37,1635.4200000003912
Sell,177,3988.37,2021-10-28 02:30:00,705941.49,707576.9100000004
Buy,177,3988.37,2021-10-28 02:30:00,705941.49,1635.4200000003912
Sell,177,4000.18,2021-10-28 02:45:00,708031.86,709667.2800000004
Buy,177,4000.18,2021-10-28 02:45:00,708031.86,1635.4200000003912
Sell,177,4008.02,2021-10-28 03:00:00,709419.54,711054.9600000004
Buy,177,4008.02,2021-10-28 03:00:00,709419.54,1635.4200000003912
Sell,177,3986.64,2021-10-28 03:15:00,705635.28,707270.7000000004
Buy,177,3986.64,2021-10-28 03:15:00,705635.28,1635.4200000003912
Sell,177,3988.31,2021-10-28 03:30:00,705930.87,707566.2900000004
Buy,177,3988.31,2021-10-28 03:30:00,705930.87,1635.4200000003912
Sell,177,3998.32,2021-10-28 03:45:00,707702.64,709338.0600000004
Buy,177,3998.32,2021-10-28 03:45:00,707702.64,1635.4200000003912
Sell,177,4018.0,2021-10-28 04:00:00,711186.0,712821.4200000004
Buy,177,4018.0,2021-10-28 04:00:00,711186.0,1635.4200000003912
Sell,177,3998.63,2021-10-28 04:15:00,707757.51,709392.9300000004
Buy,177,3998.63,2021-10-28 04:15:00,707757.51,1635.4200000003912
Sell,177,4007.36,2021-10-28 04:30:00,709302.72,710938.1400000004
Buy,177,4007.36,2021-10-28 04:30:00,709302.72,1635.4200000003912
Sell,177,3996.96,2021-10-28 04:45:00,707461.92,709097.3400000004
Buy,177,3996.96,2021-10-28 04:45:00,707461.92,1635.4200000003912
Sell,177,4012.8,2021-10-28 05:00:00,710265.6,711901.0200000004
Buy,177,4012.8,2021-10-28 05:00:00,710265.6,1635.4200000003912
Sell,177,4011.0,2021-10-28 05:15:00,709947.0,711582.4200000004
Buy,177,4011.0,2021-10-28 05:15:00,709947.0,1635.4200000003912
Sell,177,4016.98,2021-10-28 05:30:00,711005.46,712640.8800000004
Buy,177,4016.98,2021-10-28 05:30:00,711005.46,1635.4200000003912
Sell,177,4022.77,2021-10-28 05:45:00,712030.29,713665.7100000004
Buy,177,4022.77,2021-10-28 05:45:00,712030.29,1635.4200000003912
Sell,177,4005.91,2021-10-28 06:00:00,709046.07,710681.4900000003
Buy,177,4005.91,2021-10-28 06:00:00,709046.07,1635.4200000003912
Sell,177,4024.28,2021-10-28 06:15:00,712297.56,713932.9800000004
Buy,177,4024.28,2021-10-28 06:15:00,712297.56,1635.4200000003912
Sell,177,4017.77,2021-10-28 06:30:00,711145.29,712780.7100000004
Buy,177,4017.77,2021-10-28 06:30:00,711145.29,1635.4200000003912
Sell,177,4023.46,2021-10-28 06:45:00,712152.42,713787.8400000004
Buy,177,4023.46,2021-10-28 06:45:00,712152.42,1635.4200000003912
Sell,177,4016.35,2021-10-28 07:00:00,710893.95,712529.3700000003
Buy,177,4016.35,2021-10-28 07:00:00,710893.95,1635.4200000003912
Sell,177,4024.35,2021-10-28 07:15:00,712309.95,713945.3700000003
Buy,177,4024.35,2021-10-28 07:15:00,712309.95,1635.4200000003912
Sell,177,4014.97,2021-10-28 07:30:00,710649.69,712285.1100000003
Buy,177,4014.97,2021-10-28 07:30:00,710649.69,1635.4200000003912
Sell,177,4012.56,2021-10-28 07:45:00,710223.12,711858.5400000004
Buy,177,4012.56,2021-10-28 07:45:00,710223.12,1635.4200000003912
Sell,177,4050.45,2021-10-28 08:00:00,716929.65,718565.0700000004
Buy,177,4050.45,2021-10-28 08:00:00,716929.65,1635.4200000003912
Sell,177,4095.34,2021-10-28 08:15:00,724875.18,726510.6000000004
Buy,177,4095.34,2021-10-28 08:15:00,724875.18,1635.4200000003912
Sell,177,4115.29,2021-10-28 08:30:00,728406.33,730041.7500000003
Buy,177,4115.29,2021-10-28 08:30:00,728406.33,1635.4200000003912
Sell,177,4138.02,2021-10-28 08:45:00,732429.54,734064.9600000004
Buy,177,4138.02,2021-10-28 08:45:00,732429.54,1635.4200000003912
Sell,177,4143.19,2021-10-28 09:00:00,733344.6299999999,734980.0500000003
Buy,177,4143.19,2021-10-28 09:00:00,733344.6299999999,1635.4200000003912
Sell,177,4122.14,2021-10-28 09:15:00,729618.78,731254.2000000004
Buy,177,4122.14,2021-10-28 09:15:00,729618.78,1635.4200000003912
Sell,177,4129.66,2021-10-28 09:30:00,730949.82,732585.2400000003
Buy,177,4129.66,2021-10-28 09:30:00,730949.82,1635.4200000003912
Sell,177,4165.0,2021-10-28 09:45:00,737205.0,738840.4200000004
Buy,177,4165.0,2021-10-28 09:45:00,737205.0,1635.4200000003912
Sell,177,4159.88,2021-10-28 10:00:00,736298.76,737934.1800000004
Buy,177,4159.88,2021-10-28 10:00:00,736298.76,1635.4200000003912
Sell,177,4164.83,2021-10-28 10:15:00,737174.91,738810.3300000004
Buy,177,4164.83,2021-10-28 10:15:00,737174.91,1635.4200000003912
Sell,177,4159.11,2021-10-28 10:30:00,736162.47,737797.8900000004
Buy,177,4159.11,2021-10-28 10:30:00,736162.47,1635.4200000003912
Sell,177,4150.24,2021-10-28 10:45:00,734592.48,736227.9000000004
Buy,177,4150.24,2021-10-28 10:45:00,734592.48,1635.4200000003912
Sell,177,4132.6,2021-10-28 11:00:00,731470.2000000001,733105.6200000005
Buy,177,4132.6,2021-10-28 11:00:00,731470.2000000001,1635.4200000003912
Sell,177,4134.99,2021-10-28 11:15:00,731893.23,733528.6500000004
Buy,177,4134.99,2021-10-28 11:15:00,731893.23,1635.4200000003912
Sell,177,4139.73,2021-10-28 11:30:00,732732.21,734367.6300000004
Buy,177,4139.73,2021-10-28 11:30:00,732732.21,1635.4200000003912
Sell,177,4154.37,2021-10-28 11:45:00,735323.49,736958.9100000004
Buy,177,4154.37,2021-10-28 11:45:00,735323.49,1635.4200000003912
Sell,177,4163.59,2021-10-28 12:00:00,736955.43,738590.8500000004
Buy,177,4163.59,2021-10-28 12:00:00,736955.43,1635.4200000003912
Sell,177,4151.11,2021-10-28 12:15:00,734746.47,736381.8900000004
Buy,177,4151.11,2021-10-28 12:15:00,734746.47,1635.4200000003912
Sell,177,4185.25,2021-10-28 12:30:00,740789.25,742424.6700000004
Buy,177,4185.25,2021-10-28 12:30:00,740789.25,1635.4200000003912
Sell,177,4176.73,2021-10-28 12:45:00,739281.21,740916.6300000004
Buy,177,4176.73,2021-10-28 12:45:00,739281.21,1635.4200000003912
Sell,177,4175.45,2021-10-28 13:00:00,739054.65,740690.0700000004
Buy,177,4175.45,2021-10-28 13:00:00,739054.65,1635.4200000003912
Sell,177,4196.78,2021-10-28 13:15:00,742830.0599999999,744465.4800000003
Buy,177,4196.78,2021-10-28 13:15:00,742830.0599999999,1635.4200000003912
Sell,177,4184.09,2021-10-28 13:30:00,740583.93,742219.3500000004
Buy,177,4184.09,2021-10-28 13:30:00,740583.93,1635.4200000003912
Sell,177,4193.78,2021-10-28 13:45:00,742299.0599999999,743934.4800000003
Buy,177,4193.78,2021-10-28 13:45:00,742299.0599999999,1635.4200000003912
Sell,177,4182.15,2021-10-28 14:00:00,740240.5499999999,741875.9700000003
Buy,177,4182.15,2021-10-28 14:00:00,740240.5499999999,1635.4200000003912
Sell,177,4165.69,2021-10-28 14:15:00,737327.1299999999,738962.5500000003
Buy,177,4165.69,2021-10-28 14:15:00,737327.1299999999,1635.4200000003912
Sell,177,4171.11,2021-10-28 14:30:00,738286.47,739921.8900000004
Buy,177,4171.11,2021-10-28 14:30:00,738286.47,1635.4200000003912
Sell,177,4191.18,2021-10-28 14:45:00,741838.8600000001,743474.2800000005
Buy,177,4191.18,2021-10-28 14:45:00,741838.8600000001,1635.4200000003912
Sell,177,4181.67,2021-10-28 15:00:00,740155.59,741791.0100000004
Buy,177,4181.67,2021-10-28 15:00:00,740155.59,1635.4200000003912
Sell,177,4174.5,2021-10-28 15:15:00,738886.5,740521.9200000004
Buy,177,4174.5,2021-10-28 15:15:00,738886.5,1635.4200000003912
Sell,177,4168.89,2021-10-28 15:30:00,737893.53,739528.9500000004
Buy,177,4168.89,2021-10-28 15:30:00,737893.53,1635.4200000003912
Sell,177,4154.08,2021-10-28 15:45:00,735272.16,736907.5800000004
Buy,177,4154.08,2021-10-28 15:45:00,735272.16,1635.4200000003912
Sell,177,4183.97,2021-10-28 16:00:00,740562.6900000001,742198.1100000005
Buy,177,4183.97,2021-10-28 16:00:00,740562.6900000001,1635.4200000003912
Sell,177,4186.58,2021-10-28 16:15:00,741024.66,742660.0800000004
Buy,177,4186.58,2021-10-28 16:15:00,741024.66,1635.4200000003912
Sell,177,4177.6,2021-10-28 16:30:00,739435.2000000001,741070.6200000005
Buy,177,4177.6,2021-10-28 16:30:00,739435.2000000001,1635.4200000003912
Sell,177,4186.0,2021-10-28 16:45:00,740922.0,742557.4200000004
Buy,177,4186.0,2021-10-28 16:45:00,740922.0,1635.4200000003912
Sell,177,4208.16,2021-10-28 17:00:00,744844.32,746479.7400000003
Buy,177,4208.16,2021-10-28 17:00:00,744844.32,1635.4200000003912
Sell,177,4226.88,2021-10-28 17:15:00,748157.76,749793.1800000004
Buy,177,4226.88,2021-10-28 17:15:00,748157.76,1635.4200000003912
Sell,177,4224.36,2021-10-28 17:30:00,747711.72,749347.1400000004
Buy,177,4224.36,2021-10-28 17:30:00,747711.72,1635.4200000003912
Sell,177,4226.83,2021-10-28 17:45:00,748148.91,749784.3300000004
Buy,177,4226.83,2021-10-28 17:45:00,748148.91,1635.4200000003912
Sell,177,4213.48,2021-10-28 18:00:00,745785.96,747421.3800000004
Buy,177,4213.48,2021-10-28 18:00:00,745785.96,1635.4200000003912
Sell,177,4206.75,2021-10-28 18:15:00,744594.75,746230.1700000004
Buy,177,4206.75,2021-10-28 18:15:00,744594.75,1635.4200000003912
Sell,177,4142.22,2021-10-28 18:30:00,733172.9400000001,734808.3600000005
Buy,177,4142.22,2021-10-28 18:30:00,733172.9400000001,1635.4200000003912
Sell,177,4181.8,2021-10-28 18:45:00,740178.6,741814.0200000004
Buy,177,4181.8,2021-10-28 18:45:00,740178.6,1635.4200000003912
Sell,177,4162.56,2021-10-28 19:00:00,736773.1200000001,738408.5400000005
Buy,177,4162.56,2021-10-28 19:00:00,736773.1200000001,1635.4200000003912
Sell,177,4207.67,2021-10-28 19:15:00,744757.59,746393.0100000004
Buy,177,4207.67,2021-10-28 19:15:00,744757.59,1635.4200000003912
Sell,177,4234.4,2021-10-28 19:30:00,749488.7999999999,751124.2200000003
Buy,177,4234.4,2021-10-28 19:30:00,749488.7999999999,1635.4200000003912
Sell,177,4263.16,2021-10-28 19:45:00,754579.32,756214.7400000003
Buy,177,4263.16,2021-10-28 19:45:00,754579.32,1635.4200000003912
Sell,177,4280.55,2021-10-28 20:00:00,757657.35,759292.7700000004
Buy,177,4280.55,2021-10-28 20:00:00,757657.35,1635.4200000003912
Sell,177,4270.97,2021-10-28 20:15:00,755961.6900000001,757597.1100000005
Buy,177,4270.97,2021-10-28 20:15:00,755961.6900000001,1635.4200000003912
Sell,177,4273.99,2021-10-28 20:30:00,756496.23,758131.6500000004
Buy,177,4273.99,2021-10-28 20:30:00,756496.23,1635.4200000003912
Sell,177,4255.17,2021-10-28 20:45:00,753165.09,754800.5100000004
Buy,177,4255.17,2021-10-28 20:45:00,753165.09,1635.4200000003912
Sell,177,4234.1,2021-10-28 21:00:00,749435.7000000001,751071.1200000005
Buy,177,4234.1,2021-10-28 21:00:00,749435.7000000001,1635.4200000003912
Sell,177,4235.26,2021-10-28 21:15:00,749641.02,751276.4400000004
Buy,177,4235.26,2021-10-28 21:15:00,749641.02,1635.4200000003912
Sell,177,4250.47,2021-10-28 21:30:00,752333.1900000001,753968.6100000005
Buy,177,4250.47,2021-10-28 21:30:00,752333.1900000001,1635.4200000003912
Sell,177,4255.86,2021-10-28 21:45:00,753287.22,754922.6400000004
Buy,177,4255.86,2021-10-28 21:45:00,753287.22,1635.4200000003912
Sell,177,4249.23,2021-10-28 22:00:00,752113.71,753749.1300000004
Buy,177,4249.23,2021-10-28 22:00:00,752113.71,1635.4200000003912
Sell,177,4259.52,2021-10-28 22:15:00,753935.04,755570.4600000004
Buy,177,4259.52,2021-10-28 22:15:00,753935.04,1635.4200000003912
Sell,177,4263.49,2021-10-28 22:30:00,754637.73,756273.1500000004
Buy,177,4263.49,2021-10-28 22:30:00,754637.73,1635.4200000003912
Sell,177,4253.82,2021-10-28 22:45:00,752926.1399999999,754561.5600000003
Buy,177,4253.82,2021-10-28 22:45:00,752926.1399999999,1635.4200000003912
Sell,177,4269.18,2021-10-28 23:00:00,755644.8600000001,757280.2800000005
Buy,177,4269.18,2021-10-28 23:00:00,755644.8600000001,1635.4200000003912
Sell,177,4282.93,2021-10-28 23:15:00,758078.6100000001,759714.0300000005
Buy,177,4282.93,2021-10-28 23:15:00,758078.6100000001,1635.4200000003912
Sell,177,4271.18,2021-10-28 23:30:00,755998.8600000001,757634.2800000005
Buy,177,4271.18,2021-10-28 23:30:00,755998.8600000001,1635.4200000003912
Sell,177,4288.96,2021-10-28 23:45:00,759145.92,760781.3400000004
Buy,177,4288.96,2021-10-28 23:45:00,759145.92,1635.4200000003912
Sell,177,4281.81,2021-10-29 00:00:00,757880.3700000001,759515.7900000005
Buy,177,4281.81,2021-10-29 00:00:00,757880.3700000001,1635.4200000003912
Sell,177,4280.81,2021-10-29 00:15:00,757703.3700000001,759338.7900000005
Buy,177,4280.81,2021-10-29 00:15:00,757703.3700000001,1635.4200000003912
Sell,177,4303.68,2021-10-29 00:30:00,761751.3600000001,763386.7800000005
Buy,177,4303.68,2021-10-29 00:30:00,761751.3600000001,1635.4200000003912
Sell,177,4359.05,2021-10-29 00:45:00,771551.85,773187.2700000004
Buy,177,4359.05,2021-10-29 00:45:00,771551.85,1635.4200000003912
Sell,177,4396.51,2021-10-29 01:00:00,778182.27,779817.6900000004
Buy,177,4396.51,2021-10-29 01:00:00,778182.27,1635.4200000003912
Sell,177,4399.95,2021-10-29 01:15:00,778791.15,780426.5700000004
Buy,177,4399.95,2021-10-29 01:15:00,778791.15,1635.4200000003912
Sell,177,4380.09,2021-10-29 01:30:00,775275.93,776911.3500000004
Buy,177,4380.09,2021-10-29 01:30:00,775275.93,1635.4200000003912
Sell,177,4358.15,2021-10-29 01:45:00,771392.5499999999,773027.9700000003
Buy,177,4358.15,2021-10-29 01:45:00,771392.5499999999,1635.4200000003912
Sell,177,4384.03,2021-10-29 02:00:00,775973.3099999999,777608.7300000003
Buy,177,4384.03,2021-10-29 02:00:00,775973.3099999999,1635.4200000003912
Sell,177,4370.5,2021-10-29 02:15:00,773578.5,775213.9200000004
Buy,177,4370.5,2021-10-29 02:15:00,773578.5,1635.4200000003912
Sell,177,4370.33,2021-10-29 02:30:00,773548.41,775183.8300000004
Buy,177,4370.33,2021-10-29 02:30:00,773548.41,1635.4200000003912
Sell,177,4366.52,2021-10-29 02:45:00,772874.04,774509.4600000004
Buy,177,4366.52,2021-10-29 02:45:00,772874.04,1635.4200000003912
Sell,177,4389.33,2021-10-29 03:00:00,776911.41,778546.8300000004
Buy,177,4389.33,2021-10-29 03:00:00,776911.41,1635.4200000003912
Sell,177,4404.48,2021-10-29 03:15:00,779592.96,781228.3800000004
Buy,177,4404.48,2021-10-29 03:15:00,779592.96,1635.4200000003912
Sell,177,4374.31,2021-10-29 03:30:00,774252.8700000001,775888.2900000005
Buy,177,4374.31,2021-10-29 03:30:00,774252.8700000001,1635.4200000003912
Sell,177,4383.84,2021-10-29 03:45:00,775939.68,777575.1000000004
Buy,177,4383.84,2021-10-29 03:45:00,775939.68,1635.4200000003912
Sell,177,4371.58,2021-10-29 04:00:00,773769.66,775405.0800000004
Buy,177,4371.58,2021-10-29 04:00:00,773769.66,1635.4200000003912
Sell,177,4377.3,2021-10-29 04:15:00,774782.1,776417.5200000004
Buy,177,4377.3,2021-10-29 04:15:00,774782.1,1635.4200000003912
Sell,177,4354.0,2021-10-29 04:30:00,770658.0,772293.4200000004
Buy,177,4354.0,2021-10-29 04:30:00,770658.0,1635.4200000003912
Sell,177,4357.87,2021-10-29 04:45:00,771342.99,772978.4100000004
Buy,177,4357.87,2021-10-29 04:45:00,771342.99,1635.4200000003912
Sell,177,4352.58,2021-10-29 05:00:00,770406.66,772042.0800000004
Buy,177,4352.58,2021-10-29 05:00:00,770406.66,1635.4200000003912
Sell,177,4334.14,2021-10-29 05:15:00,767142.78,768778.2000000004
Buy,177,4334.14,2021-10-29 05:15:00,767142.78,1635.4200000003912
Sell,177,4311.72,2021-10-29 05:30:00,763174.4400000001,764809.8600000005
Buy,177,4311.72,2021-10-29 05:30:00,763174.4400000001,1635.4200000003912
Sell,177,4326.07,2021-10-29 05:45:00,765714.3899999999,767349.8100000003
Buy,177,4326.07,2021-10-29 05:45:00,765714.3899999999,1635.4200000003912
Sell,177,4343.37,2021-10-29 06:00:00,768776.49,770411.9100000004
Buy,177,4343.37,2021-10-29 06:00:00,768776.49,1635.4200000003912
Sell,177,4333.62,2021-10-29 06:15:00,767050.74,768686.1600000004
Buy,177,4333.62,2021-10-29 06:15:00,767050.74,1635.4200000003912
Sell,177,4353.24,2021-10-29 06:30:00,770523.48,772158.9000000004
Buy,177,4353.24,2021-10-29 06:30:00,770523.48,1635.4200000003912
Sell,177,4345.31,2021-10-29 06:45:00,769119.8700000001,770755.2900000005
Buy,177,4345.31,2021-10-29 06:45:00,769119.8700000001,1635.4200000003912
Sell,177,4324.03,2021-10-29 07:00:00,765353.3099999999,766988.7300000003
Buy,177,4324.03,2021-10-29 07:00:00,765353.3099999999,1635.4200000003912
Sell,177,4319.41,2021-10-29 07:15:00,764535.57,766170.9900000003
Buy,177,4319.41,2021-10-29 07:15:00,764535.57,1635.4200000003912
Sell,177,4312.37,2021-10-29 07:30:00,763289.49,764924.9100000004
Buy,177,4312.37,2021-10-29 07:30:00,763289.49,1635.4200000003912
Sell,177,4312.78,2021-10-29 07:45:00,763362.0599999999,764997.4800000003
Buy,177,4312.78,2021-10-29 07:45:00,763362.0599999999,1635.4200000003912
Sell,177,4329.07,2021-10-29 08:00:00,766245.3899999999,767880.8100000003
Buy,177,4329.07,2021-10-29 08:00:00,766245.3899999999,1635.4200000003912
Sell,177,4310.67,2021-10-29 08:15:00,762988.59,764624.0100000004
Buy,177,4310.67,2021-10-29 08:15:00,762988.59,1635.4200000003912
Sell,177,4312.9,2021-10-29 08:30:00,763383.2999999999,765018.7200000003
Buy,177,4312.9,2021-10-29 08:30:00,763383.2999999999,1635.4200000003912
Sell,177,4344.93,2021-10-29 08:45:00,769052.6100000001,770688.0300000005
Buy,177,4344.93,2021-10-29 08:45:00,769052.6100000001,1635.4200000003912
Sell,177,4361.15,2021-10-29 09:00:00,771923.5499999999,773558.9700000003
Buy,177,4361.15,2021-10-29 09:00:00,771923.5499999999,1635.4200000003912
Sell,177,4357.33,2021-10-29 09:15:00,771247.41,772882.8300000004
Buy,177,4357.33,2021-10-29 09:15:00,771247.41,1635.4200000003912
Sell,177,4339.92,2021-10-29 09:30:00,768165.84,769801.2600000004
Buy,177,4339.92,2021-10-29 09:30:00,768165.84,1635.4200000003912
Sell,177,4333.32,2021-10-29 09:45:00,766997.6399999999,768633.0600000003
Buy,177,4333.32,2021-10-29 09:45:00,766997.6399999999,1635.4200000003912
Sell,177,4335.39,2021-10-29 10:00:00,767364.03,768999.4500000004
Buy,177,4335.39,2021-10-29 10:00:00,767364.03,1635.4200000003912
Sell,177,4319.12,2021-10-29 10:15:00,764484.24,766119.6600000004
Buy,177,4319.12,2021-10-29 10:15:00,764484.24,1635.4200000003912
Sell,177,4326.37,2021-10-29 10:30:00,765767.49,767402.9100000004
Buy,177,4326.37,2021-10-29 10:30:00,765767.49,1635.4200000003912
Sell,177,4335.79,2021-10-29 10:45:00,767434.83,769070.2500000003
Buy,177,4335.79,2021-10-29 10:45:00,767434.83,1635.4200000003912
Sell,177,4334.12,2021-10-29 11:00:00,767139.24,768774.6600000004
Buy,177,4334.12,2021-10-29 11:00:00,767139.24,1635.4200000003912
Sell,177,4331.93,2021-10-29 11:15:00,766751.6100000001,768387.0300000005
Buy,177,4331.93,2021-10-29 11:15:00,766751.6100000001,1635.4200000003912
Sell,177,4295.06,2021-10-29 11:30:00,760225.6200000001,761861.0400000005
Buy,177,4295.06,2021-10-29 11:30:00,760225.6200000001,1635.4200000003912
Sell,177,4323.18,2021-10-29 11:45:00,765202.8600000001,766838.2800000005
Buy,177,4323.18,2021-10-29 11:45:00,765202.8600000001,1635.4200000003912
Sell,177,4308.84,2021-10-29 12:00:00,762664.68,764300.1000000004
Buy,177,4308.84,2021-10-29 12:00:00,762664.68,1635.4200000003912
Sell,177,4342.22,2021-10-29 12:15:00,768572.9400000001,770208.3600000005
Buy,177,4342.22,2021-10-29 12:15:00,768572.9400000001,1635.4200000003912
Sell,177,4337.04,2021-10-29 12:30:00,767656.08,769291.5000000003
Buy,177,4337.04,2021-10-29 12:30:00,767656.08,1635.4200000003912
Sell,177,4317.5,2021-10-29 12:45:00,764197.5,765832.9200000004
Buy,177,4317.5,2021-10-29 12:45:00,764197.5,1635.4200000003912
Sell,177,4305.47,2021-10-29 13:00:00,762068.1900000001,763703.6100000005
Buy,177,4305.47,2021-10-29 13:00:00,762068.1900000001,1635.4200000003912
Sell,177,4325.72,2021-10-29 13:15:00,765652.4400000001,767287.8600000005
Buy,177,4325.72,2021-10-29 13:15:00,765652.4400000001,1635.4200000003912
Sell,177,4332.4,2021-10-29 13:30:00,766834.7999999999,768470.2200000003
Buy,177,4332.4,2021-10-29 13:30:00,766834.7999999999,1635.4200000003912
Sell,177,4372.0,2021-10-29 13:45:00,773844.0,775479.4200000004
Buy,177,4372.0,2021-10-29 13:45:00,773844.0,1635.4200000003912
Sell,177,4355.16,2021-10-29 14:00:00,770863.32,772498.7400000003
Buy,177,4355.16,2021-10-29 14:00:00,770863.32,1635.4200000003912
Sell,177,4332.61,2021-10-29 14:15:00,766871.97,768507.3900000004
Buy,177,4332.61,2021-10-29 14:15:00,766871.97,1635.4200000003912
Sell,177,4343.64,2021-10-29 14:30:00,768824.28,770459.7000000004
Buy,177,4343.64,2021-10-29 14:30:00,768824.28,1635.4200000003912
Sell,177,4346.19,2021-10-29 14:45:00,769275.6299999999,770911.0500000003
Buy,177,4346.19,2021-10-29 14:45:00,769275.6299999999,1635.4200000003912
Sell,177,4394.61,2021-10-29 15:00:00,777845.97,779481.3900000004
Buy,177,4394.61,2021-10-29 15:00:00,777845.97,1635.4200000003912
Sell,177,4427.87,2021-10-29 15:15:00,783732.99,785368.4100000004
Buy,177,4427.87,2021-10-29 15:15:00,783732.99,1635.4200000003912
Sell,177,4419.13,2021-10-29 15:30:00,782186.01,783821.4300000004
Buy,177,4419.13,2021-10-29 15:30:00,782186.01,1635.4200000003912
Sell,177,4444.49,2021-10-29 15:45:00,786674.73,788310.1500000004
Buy,177,4444.49,2021-10-29 15:45:00,786674.73,1635.4200000003912
Sell,177,4444.33,2021-10-29 16:00:00,786646.41,788281.8300000004
Buy,177,4444.33,2021-10-29 16:00:00,786646.41,1635.4200000003912
Sell,177,4440.65,2021-10-29 16:15:00,785995.0499999999,787630.4700000003
Buy,177,4440.65,2021-10-29 16:15:00,785995.0499999999,1635.4200000003912
Sell,177,4418.25,2021-10-29 16:30:00,782030.25,783665.6700000004
Buy,177,4418.25,2021-10-29 16:30:00,782030.25,1635.4200000003912
Sell,177,4429.25,2021-10-29 16:45:00,783977.25,785612.6700000004
Buy,177,4429.25,2021-10-29 16:45:00,783977.25,1635.4200000003912
Sell,177,4427.84,2021-10-29 17:00:00,783727.68,785363.1000000004
Buy,177,4427.84,2021-10-29 17:00:00,783727.68,1635.4200000003912
Sell,177,4437.96,2021-10-29 17:15:00,785518.92,787154.3400000004
Buy,177,4437.96,2021-10-29 17:15:00,785518.92,1635.4200000003912
Sell,177,4425.35,2021-10-29 17:30:00,783286.9500000001,784922.3700000005
Buy,177,4425.35,2021-10-29 17:30:00,783286.9500000001,1635.4200000003912
Sell,177,4420.75,2021-10-29 17:45:00,782472.75,784108.1700000004
Buy,177,4420.75,2021-10-29 17:45:00,782472.75,1635.4200000003912
Sell,177,4425.79,2021-10-29 18:00:00,783364.83,785000.2500000003
Buy,177,4425.79,2021-10-29 18:00:00,783364.83,1635.4200000003912
Sell,177,4394.84,2021-10-29 18:15:00,777886.68,779522.1000000004
Buy,177,4394.84,2021-10-29 18:15:00,777886.68,1635.4200000003912
Sell,177,4383.26,2021-10-29 18:30:00,775837.02,777472.4400000004
Buy,177,4383.26,2021-10-29 18:30:00,775837.02,1635.4200000003912
Sell,177,4378.11,2021-10-29 18:45:00,774925.47,776560.8900000004
Buy,177,4378.11,2021-10-29 18:45:00,774925.47,1635.4200000003912
Sell,177,4387.94,2021-10-29 19:00:00,776665.3799999999,778300.8000000003
Buy,177,4387.94,2021-10-29 19:00:00,776665.3799999999,1635.4200000003912
Sell,177,4383.2,2021-10-29 19:15:00,775826.4,777461.8200000004
Buy,177,4383.2,2021-10-29 19:15:00,775826.4,1635.4200000003912
Sell,177,4375.33,2021-10-29 19:30:00,774433.41,776068.8300000004
Buy,177,4375.33,2021-10-29 19:30:00,774433.41,1635.4200000003912
Sell,177,4406.52,2021-10-29 19:45:00,779954.04,781589.4600000004
Buy,177,4406.52,2021-10-29 19:45:00,779954.04,1635.4200000003912
Sell,177,4414.61,2021-10-29 20:00:00,781385.97,783021.3900000004
Buy,177,4414.61,2021-10-29 20:00:00,781385.97,1635.4200000003912
Sell,177,4409.54,2021-10-29 20:15:00,780488.58,782124.0000000003
Buy,177,4409.54,2021-10-29 20:15:00,780488.58,1635.4200000003912
Sell,177,4414.62,2021-10-29 20:30:00,781387.74,783023.1600000004
Buy,177,4414.62,2021-10-29 20:30:00,781387.74,1635.4200000003912
Sell,177,4402.75,2021-10-29 20:45:00,779286.75,780922.1700000004
Buy,177,4402.75,2021-10-29 20:45:00,779286.75,1635.4200000003912
Sell,177,4397.01,2021-10-29 21:00:00,778270.77,779906.1900000004
Buy,177,4397.01,2021-10-29 21:00:00,778270.77,1635.4200000003912
Sell,177,4395.26,2021-10-29 21:15:00,777961.02,779596.4400000004
Buy,177,4395.26,2021-10-29 21:15:00,777961.02,1635.4200000003912
Sell,177,4417.57,2021-10-29 21:30:00,781909.8899999999,783545.3100000003
Buy,177,4417.57,2021-10-29 21:30:00,781909.8899999999,1635.4200000003912
Sell,177,4419.31,2021-10-29 21:45:00,782217.8700000001,783853.2900000005
Buy,177,4419.31,2021-10-29 21:45:00,782217.8700000001,1635.4200000003912
Sell,177,4414.61,2021-10-29 22:00:00,781385.97,783021.3900000004
Buy,177,4414.61,2021-10-29 22:00:00,781385.97,1635.4200000003912
Sell,177,4403.23,2021-10-29 22:15:00,779371.71,781007.1300000004
Buy,177,4403.23,2021-10-29 22:15:00,779371.71,1635.4200000003912
Sell,177,4415.91,2021-10-29 22:30:00,781616.07,783251.4900000003
Buy,177,4415.91,2021-10-29 22:30:00,781616.07,1635.4200000003912
Sell,177,4419.22,2021-10-29 22:45:00,782201.9400000001,783837.3600000005
Buy,177,4419.22,2021-10-29 22:45:00,782201.9400000001,1635.4200000003912
Sell,177,4407.44,2021-10-29 23:00:00,780116.8799999999,781752.3000000003
Buy,177,4407.44,2021-10-29 23:00:00,780116.8799999999,1635.4200000003912
Sell,177,4419.41,2021-10-29 23:15:00,782235.57,783870.9900000003
Buy,177,4419.41,2021-10-29 23:15:00,782235.57,1635.4200000003912
Sell,177,4405.71,2021-10-29 23:30:00,779810.67,781446.0900000004
Buy,177,4405.71,2021-10-29 23:30:00,779810.67,1635.4200000003912
Sell,177,4421.53,2021-10-29 23:45:00,782610.8099999999,784246.2300000003
Buy,177,4421.53,2021-10-29 23:45:00,782610.8099999999,1635.4200000003912
Sell,177,4389.9,2021-10-30 00:00:00,777012.2999999999,778647.7200000003
Buy,177,4389.9,2021-10-30 00:00:00,777012.2999999999,1635.4200000003912
Sell,177,4382.79,2021-10-30 00:15:00,775753.83,777389.2500000003
Buy,177,4382.79,2021-10-30 00:15:00,775753.83,1635.4200000003912
Sell,177,4382.04,2021-10-30 00:30:00,775621.08,777256.5000000003
Buy,177,4382.04,2021-10-30 00:30:00,775621.08,1635.4200000003912
Sell,177,4378.35,2021-10-30 00:45:00,774967.9500000001,776603.3700000005
Buy,177,4378.35,2021-10-30 00:45:00,774967.9500000001,1635.4200000003912
Sell,177,4389.5,2021-10-30 01:00:00,776941.5,778576.9200000004
Buy,177,4389.5,2021-10-30 01:00:00,776941.5,1635.4200000003912
Sell,177,4356.72,2021-10-30 01:15:00,771139.4400000001,772774.8600000005
Buy,177,4356.72,2021-10-30 01:15:00,771139.4400000001,1635.4200000003912
Sell,177,4380.65,2021-10-30 01:30:00,775375.0499999999,777010.4700000003
Buy,177,4380.65,2021-10-30 01:30:00,775375.0499999999,1635.4200000003912
Sell,177,4364.72,2021-10-30 01:45:00,772555.4400000001,774190.8600000005
Buy,177,4364.72,2021-10-30 01:45:00,772555.4400000001,1635.4200000003912
Sell,177,4357.36,2021-10-30 02:00:00,771252.72,772888.1400000004
Buy,177,4357.36,2021-10-30 02:00:00,771252.72,1635.4200000003912
Sell,177,4366.01,2021-10-30 02:15:00,772783.77,774419.1900000004
Buy,177,4366.01,2021-10-30 02:15:00,772783.77,1635.4200000003912
Sell,177,4363.89,2021-10-30 02:30:00,772408.53,774043.9500000004
Buy,177,4363.89,2021-10-30 02:30:00,772408.53,1635.4200000003912
Sell,177,4363.59,2021-10-30 02:45:00,772355.43,773990.8500000004
Buy,177,4363.59,2021-10-30 02:45:00,772355.43,1635.4200000003912
Sell,177,4356.14,2021-10-30 03:00:00,771036.78,772672.2000000004
Buy,177,4356.14,2021-10-30 03:00:00,771036.78,1635.4200000003912
Sell,177,4339.0,2021-10-30 03:15:00,768003.0,769638.4200000004
Buy,177,4339.0,2021-10-30 03:15:00,768003.0,1635.4200000003912
Sell,177,4351.27,2021-10-30 03:30:00,770174.79,771810.2100000004
Buy,177,4351.27,2021-10-30 03:30:00,770174.79,1635.4200000003912
Sell,177,4346.87,2021-10-30 03:45:00,769395.99,771031.4100000004
Buy,177,4346.87,2021-10-30 03:45:00,769395.99,1635.4200000003912
Sell,177,4360.42,2021-10-30 04:00:00,771794.34,773429.7600000004
Buy,177,4360.42,2021-10-30 04:00:00,771794.34,1635.4200000003912
Sell,177,4361.25,2021-10-30 04:15:00,771941.25,773576.6700000004
Buy,177,4361.25,2021-10-30 04:15:00,771941.25,1635.4200000003912
Sell,177,4349.3,2021-10-30 04:30:00,769826.1,771461.5200000004
Buy,177,4349.3,2021-10-30 04:30:00,769826.1,1635.4200000003912
Sell,177,4341.49,2021-10-30 04:45:00,768443.73,770079.1500000004
Buy,177,4341.49,2021-10-30 04:45:00,768443.73,1635.4200000003912
Sell,177,4355.52,2021-10-30 05:00:00,770927.04,772562.4600000004
Buy,177,4355.52,2021-10-30 05:00:00,770927.04,1635.4200000003912
Sell,177,4361.17,2021-10-30 05:15:00,771927.09,773562.5100000004
Buy,177,4361.17,2021-10-30 05:15:00,771927.09,1635.4200000003912
Sell,177,4366.85,2021-10-30 05:30:00,772932.4500000001,774567.8700000005
Buy,177,4366.85,2021-10-30 05:30:00,772932.4500000001,1635.4200000003912
Sell,177,4361.3,2021-10-30 05:45:00,771950.1,773585.5200000004
Buy,177,4361.3,2021-10-30 05:45:00,771950.1,1635.4200000003912
Sell,177,4359.18,2021-10-30 06:00:00,771574.8600000001,773210.2800000005
Buy,177,4359.18,2021-10-30 06:00:00,771574.8600000001,1635.4200000003912
Sell,177,4368.7,2021-10-30 06:15:00,773259.9,774895.3200000004
Buy,177,4368.7,2021-10-30 06:15:00,773259.9,1635.4200000003912
Sell,177,4376.32,2021-10-30 06:30:00,774608.6399999999,776244.0600000003
Buy,177,4376.32,2021-10-30 06:30:00,774608.6399999999,1635.4200000003912
Sell,177,4367.58,2021-10-30 06:45:00,773061.66,774697.0800000004
Buy,177,4367.58,2021-10-30 06:45:00,773061.66,1635.4200000003912
Sell,177,4355.29,2021-10-30 07:00:00,770886.33,772521.7500000003
Buy,177,4355.29,2021-10-30 07:00:00,770886.33,1635.4200000003912
Sell,177,4353.37,2021-10-30 07:15:00,770546.49,772181.9100000004
Buy,177,4353.37,2021-10-30 07:15:00,770546.49,1635.4200000003912
Sell,177,4361.09,2021-10-30 07:30:00,771912.93,773548.3500000004
Buy,177,4361.09,2021-10-30 07:30:00,771912.93,1635.4200000003912
Sell,177,4353.85,2021-10-30 07:45:00,770631.4500000001,772266.8700000005
Buy,177,4353.85,2021-10-30 07:45:00,770631.4500000001,1635.4200000003912
Sell,177,4344.65,2021-10-30 08:00:00,769003.0499999999,770638.4700000003
Buy,177,4344.65,2021-10-30 08:00:00,769003.0499999999,1635.4200000003912
Sell,177,4332.59,2021-10-30 08:15:00,766868.43,768503.8500000004
Buy,177,4332.59,2021-10-30 08:15:00,766868.43,1635.4200000003912
Sell,177,4313.07,2021-10-30 08:30:00,763413.3899999999,765048.8100000003
Buy,177,4313.07,2021-10-30 08:30:00,763413.3899999999,1635.4200000003912
Sell,177,4322.75,2021-10-30 08:45:00,765126.75,766762.1700000004
Buy,177,4322.75,2021-10-30 08:45:00,765126.75,1635.4200000003912
Sell,177,4325.2,2021-10-30 09:00:00,765560.4,767195.8200000004
Buy,177,4325.2,2021-10-30 09:00:00,765560.4,1635.4200000003912
Sell,177,4327.53,2021-10-30 09:15:00,765972.8099999999,767608.2300000003
Buy,177,4327.53,2021-10-30 09:15:00,765972.8099999999,1635.4200000003912
Sell,177,4334.54,2021-10-30 09:30:00,767213.58,768849.0000000003
Buy,177,4334.54,2021-10-30 09:30:00,767213.58,1635.4200000003912
Sell,177,4323.38,2021-10-30 09:45:00,765238.26,766873.6800000004
Buy,177,4323.38,2021-10-30 09:45:00,765238.26,1635.4200000003912
Sell,177,4314.25,2021-10-30 10:00:00,763622.25,765257.6700000004
Buy,177,4314.25,2021-10-30 10:00:00,763622.25,1635.4200000003912
Sell,177,4323.37,2021-10-30 10:15:00,765236.49,766871.9100000004
Buy,177,4323.37,2021-10-30 10:15:00,765236.49,1635.4200000003912
Sell,177,4343.52,2021-10-30 10:30:00,768803.04,770438.4600000004
Buy,177,4343.52,2021-10-30 10:30:00,768803.04,1635.4200000003912
Sell,177,4350.0,2021-10-30 10:45:00,769950.0,771585.4200000004
Buy,177,4350.0,2021-10-30 10:45:00,769950.0,1635.4200000003912
Sell,177,4352.4,2021-10-30 11:00:00,770374.7999999999,772010.2200000003
Buy,177,4352.4,2021-10-30 11:00:00,770374.7999999999,1635.4200000003912
Sell,177,4341.94,2021-10-30 11:30:00,768523.3799999999,770158.8000000003
Buy,177,4341.94,2021-10-30 11:30:00,768523.3799999999,1635.4200000003912
Sell,177,4337.89,2021-10-30 11:45:00,767806.53,769441.9500000004
Buy,177,4337.89,2021-10-30 11:45:00,767806.53,1635.4200000003912
Sell,177,4326.31,2021-10-30 12:00:00,765756.8700000001,767392.2900000005
Buy,177,4326.31,2021-10-30 12:00:00,765756.8700000001,1635.4200000003912
Sell,177,4332.32,2021-10-30 12:15:00,766820.6399999999,768456.0600000003
Buy,177,4332.32,2021-10-30 12:15:00,766820.6399999999,1635.4200000003912
Sell,177,4321.26,2021-10-30 12:30:00,764863.02,766498.4400000004
Buy,177,4321.26,2021-10-30 12:30:00,764863.02,1635.4200000003912
Sell,177,4329.0,2021-10-30 12:45:00,766233.0,767868.4200000004
Buy,177,4329.0,2021-10-30 12:45:00,766233.0,1635.4200000003912
Sell,177,4312.24,2021-10-30 13:00:00,763266.48,764901.9000000004
Buy,177,4312.24,2021-10-30 13:00:00,763266.48,1635.4200000003912
Sell,177,4324.08,2021-10-30 13:15:00,765362.16,766997.5800000004
Buy,177,4324.08,2021-10-30 13:15:00,765362.16,1635.4200000003912
Sell,177,4316.11,2021-10-30 13:30:00,763951.47,765586.8900000004
Buy,177,4316.11,2021-10-30 13:30:00,763951.47,1635.4200000003912
Sell,177,4313.75,2021-10-30 13:45:00,763533.75,765169.1700000004
Buy,177,4313.75,2021-10-30 13:45:00,763533.75,1635.4200000003912
Sell,177,4312.0,2021-10-30 14:00:00,763224.0,764859.4200000004
Buy,177,4312.0,2021-10-30 14:00:00,763224.0,1635.4200000003912
Sell,177,4271.88,2021-10-30 14:15:00,756122.76,757758.1800000004
Buy,177,4271.88,2021-10-30 14:15:00,756122.76,1635.4200000003912
Sell,177,4276.71,2021-10-30 14:45:00,756977.67,758613.0900000004
Buy,177,4276.71,2021-10-30 14:45:00,756977.67,1635.4200000003912
Sell,177,4291.97,2021-10-30 15:00:00,759678.6900000001,761314.1100000005
Buy,177,4291.97,2021-10-30 15:00:00,759678.6900000001,1635.4200000003912
Sell,177,4285.27,2021-10-30 15:15:00,758492.79,760128.2100000004
Buy,177,4285.27,2021-10-30 15:15:00,758492.79,1635.4200000003912
Sell,177,4286.67,2021-10-30 15:30:00,758740.59,760376.0100000004
Buy,177,4286.67,2021-10-30 15:30:00,758740.59,1635.4200000003912
Sell,177,4284.53,2021-10-30 15:45:00,758361.8099999999,759997.2300000003
Buy,177,4284.53,2021-10-30 15:45:00,758361.8099999999,1635.4200000003912
Sell,177,4292.06,2021-10-30 16:00:00,759694.6200000001,761330.0400000005
Buy,177,4292.06,2021-10-30 16:00:00,759694.6200000001,1635.4200000003912
Sell,177,4285.96,2021-10-30 16:15:00,758614.92,760250.3400000004
Buy,177,4285.96,2021-10-30 16:15:00,758614.92,1635.4200000003912
Sell,177,4275.67,2021-10-30 16:30:00,756793.59,758429.0100000004
Buy,177,4275.67,2021-10-30 16:30:00,756793.59,1635.4200000003912
Sell,177,4287.88,2021-10-30 16:45:00,758954.76,760590.1800000004
Buy,177,4287.88,2021-10-30 16:45:00,758954.76,1635.4200000003912
Sell,177,4286.06,2021-10-30 17:00:00,758632.6200000001,760268.0400000005
Buy,177,4286.06,2021-10-30 17:00:00,758632.6200000001,1635.4200000003912
Sell,177,4297.35,2021-10-30 17:15:00,760630.9500000001,762266.3700000005
Buy,177,4297.35,2021-10-30 17:15:00,760630.9500000001,1635.4200000003912
Sell,177,4296.57,2021-10-30 17:30:00,760492.8899999999,762128.3100000003
Buy,177,4296.57,2021-10-30 17:30:00,760492.8899999999,1635.4200000003912
Sell,177,4304.89,2021-10-30 17:45:00,761965.53,763600.9500000004
Buy,177,4304.89,2021-10-30 17:45:00,761965.53,1635.4200000003912
Sell,177,4307.11,2021-10-30 18:00:00,762358.47,763993.8900000004
Buy,177,4307.11,2021-10-30 18:00:00,762358.47,1635.4200000003912
Sell,177,4305.26,2021-10-30 18:15:00,762031.02,763666.4400000004
Buy,177,4305.26,2021-10-30 18:15:00,762031.02,1635.4200000003912
Sell,177,4306.77,2021-10-30 18:30:00,762298.29,763933.7100000004
Buy,177,4306.77,2021-10-30 18:30:00,762298.29,1635.4200000003912
Sell,177,4325.37,2021-10-30 18:45:00,765590.49,767225.9100000004
Buy,177,4325.37,2021-10-30 18:45:00,765590.49,1635.4200000003912
Sell,177,4327.63,2021-10-30 19:00:00,765990.51,767625.9300000004
Buy,177,4327.63,2021-10-30 19:00:00,765990.51,1635.4200000003912
Sell,177,4329.64,2021-10-30 19:15:00,766346.28,767981.7000000004
Buy,177,4329.64,2021-10-30 19:15:00,766346.28,1635.4200000003912
Sell,177,4336.96,2021-10-30 19:30:00,767641.92,769277.3400000004
Buy,177,4336.96,2021-10-30 19:30:00,767641.92,1635.4200000003912
Sell,177,4338.85,2021-10-30 19:45:00,767976.4500000001,769611.8700000005
Buy,177,4338.85,2021-10-30 19:45:00,767976.4500000001,1635.4200000003912
Sell,177,4344.68,2021-10-30 20:00:00,769008.3600000001,770643.7800000005
Buy,177,4344.68,2021-10-30 20:00:00,769008.3600000001,1635.4200000003912
Sell,177,4332.22,2021-10-30 20:15:00,766802.9400000001,768438.3600000005
Buy,177,4332.22,2021-10-30 20:15:00,766802.9400000001,1635.4200000003912
Sell,177,4319.4,2021-10-30 20:30:00,764533.7999999999,766169.2200000003
Buy,177,4319.4,2021-10-30 20:30:00,764533.7999999999,1635.4200000003912
Sell,177,4311.76,2021-10-30 20:45:00,763181.52,764816.9400000004
Buy,177,4311.76,2021-10-30 20:45:00,763181.52,1635.4200000003912
Sell,177,4306.95,2021-10-30 21:00:00,762330.15,763965.5700000004
Buy,177,4306.95,2021-10-30 21:00:00,762330.15,1635.4200000003912
Sell,177,4291.08,2021-10-30 21:15:00,759521.16,761156.5800000004
Buy,177,4291.08,2021-10-30 21:15:00,759521.16,1635.4200000003912
Sell,177,4300.67,2021-10-30 21:30:00,761218.59,762854.0100000004
Buy,177,4300.67,2021-10-30 21:30:00,761218.59,1635.4200000003912
Sell,177,4286.6,2021-10-30 21:45:00,758728.2000000001,760363.6200000005
Buy,177,4286.6,2021-10-30 21:45:00,758728.2000000001,1635.4200000003912
Sell,177,4287.01,2021-10-30 22:00:00,758800.77,760436.1900000004
Buy,177,4287.01,2021-10-30 22:00:00,758800.77,1635.4200000003912
Sell,177,4277.03,2021-10-30 22:15:00,757034.3099999999,758669.7300000003
Buy,177,4277.03,2021-10-30 22:15:00,757034.3099999999,1635.4200000003912
Sell,177,4263.5,2021-10-30 22:30:00,754639.5,756274.9200000004
Buy,177,4263.5,2021-10-30 22:30:00,754639.5,1635.4200000003912
Sell,177,4290.06,2021-10-30 22:45:00,759340.6200000001,760976.0400000005
Buy,177,4290.06,2021-10-30 22:45:00,759340.6200000001,1635.4200000003912
Sell,177,4307.2,2021-10-30 23:00:00,762374.4,764009.8200000004
Buy,177,4307.2,2021-10-30 23:00:00,762374.4,1635.4200000003912
Sell,177,4295.78,2021-10-30 23:15:00,760353.0599999999,761988.4800000003
Buy,177,4295.78,2021-10-30 23:15:00,760353.0599999999,1635.4200000003912
Sell,177,4317.4,2021-10-30 23:30:00,764179.7999999999,765815.2200000003
Buy,177,4317.4,2021-10-30 23:30:00,764179.7999999999,1635.4200000003912
Sell,177,4324.82,2021-10-30 23:45:00,765493.1399999999,767128.5600000003
Buy,177,4324.82,2021-10-30 23:45:00,765493.1399999999,1635.4200000003912
Sell,177,4373.55,2021-10-31 00:00:00,774118.35,775753.7700000004
Buy,177,4373.55,2021-10-31 00:00:00,774118.35,1635.4200000003912
Sell,177,4376.52,2021-10-31 00:15:00,774644.04,776279.4600000004
Buy,177,4376.52,2021-10-31 00:15:00,774644.04,1635.4200000003912
Sell,177,4385.03,2021-10-31 00:30:00,776150.3099999999,777785.7300000003
Buy,177,4385.03,2021-10-31 00:30:00,776150.3099999999,1635.4200000003912
Sell,177,4388.0,2021-10-31 00:45:00,776676.0,778311.4200000004
Buy,177,4388.0,2021-10-31 00:45:00,776676.0,1635.4200000003912
Sell,177,4384.25,2021-10-31 01:00:00,776012.25,777647.6700000004
Buy,177,4384.25,2021-10-31 01:00:00,776012.25,1635.4200000003912
Sell,177,4361.58,2021-10-31 01:15:00,771999.66,773635.0800000004
Buy,177,4361.58,2021-10-31 01:15:00,771999.66,1635.4200000003912
Sell,177,4360.33,2021-10-31 01:30:00,771778.41,773413.8300000004
Buy,177,4360.33,2021-10-31 01:30:00,771778.41,1635.4200000003912
Sell,177,4366.56,2021-10-31 01:45:00,772881.1200000001,774516.5400000005
Buy,177,4366.56,2021-10-31 01:45:00,772881.1200000001,1635.4200000003912
Sell,177,4390.48,2021-10-31 02:00:00,777114.96,778750.3800000004
Buy,177,4390.48,2021-10-31 02:00:00,777114.96,1635.4200000003912
Sell,177,4394.15,2021-10-31 02:15:00,777764.5499999999,779399.9700000003
Buy,177,4394.15,2021-10-31 02:15:00,777764.5499999999,1635.4200000003912
Sell,177,4379.39,2021-10-31 02:30:00,775152.03,776787.4500000004
Buy,177,4379.39,2021-10-31 02:30:00,775152.03,1635.4200000003912
Sell,177,4368.6,2021-10-31 02:45:00,773242.2000000001,774877.6200000005
Buy,177,4368.6,2021-10-31 02:45:00,773242.2000000001,1635.4200000003912
Sell,177,4362.0,2021-10-31 03:00:00,772074.0,773709.4200000004
Buy,177,4362.0,2021-10-31 03:00:00,772074.0,1635.4200000003912
Sell,177,4372.36,2021-10-31 03:15:00,773907.72,775543.1400000004
Buy,177,4372.36,2021-10-31 03:15:00,773907.72,1635.4200000003912
Sell,177,4379.56,2021-10-31 03:30:00,775182.1200000001,776817.5400000005
Buy,177,4379.56,2021-10-31 03:30:00,775182.1200000001,1635.4200000003912
Sell,177,4373.52,2021-10-31 03:45:00,774113.04,775748.4600000004
Buy,177,4373.52,2021-10-31 03:45:00,774113.04,1635.4200000003912
Sell,177,4367.18,2021-10-31 04:00:00,772990.8600000001,774626.2800000005
Buy,177,4367.18,2021-10-31 04:00:00,772990.8600000001,1635.4200000003912
Sell,177,4380.34,2021-10-31 04:15:00,775320.18,776955.6000000004
Buy,177,4380.34,2021-10-31 04:15:00,775320.18,1635.4200000003912
Sell,177,4382.29,2021-10-31 04:30:00,775665.33,777300.7500000003
Buy,177,4382.29,2021-10-31 04:30:00,775665.33,1635.4200000003912
Sell,177,4370.19,2021-10-31 04:45:00,773523.6299999999,775159.0500000003
Buy,177,4370.19,2021-10-31 04:45:00,773523.6299999999,1635.4200000003912
Sell,177,4349.11,2021-10-31 05:00:00,769792.47,771427.8900000004
Buy,177,4349.11,2021-10-31 05:00:00,769792.47,1635.4200000003912
Sell,177,4324.31,2021-10-31 05:15:00,765402.8700000001,767038.2900000005
Buy,177,4324.31,2021-10-31 05:15:00,765402.8700000001,1635.4200000003912
Sell,177,4325.76,2021-10-31 05:30:00,765659.52,767294.9400000004
Buy,177,4325.76,2021-10-31 05:30:00,765659.52,1635.4200000003912
Sell,177,4330.58,2021-10-31 05:45:00,766512.66,768148.0800000004
Buy,177,4330.58,2021-10-31 05:45:00,766512.66,1635.4200000003912
Sell,177,4318.16,2021-10-31 06:00:00,764314.32,765949.7400000003
Buy,177,4318.16,2021-10-31 06:00:00,764314.32,1635.4200000003912
Sell,177,4315.43,2021-10-31 06:15:00,763831.1100000001,765466.5300000005
Buy,177,4315.43,2021-10-31 06:15:00,763831.1100000001,1635.4200000003912
Sell,177,4304.9,2021-10-31 06:30:00,761967.2999999999,763602.7200000003
Buy,177,4304.9,2021-10-31 06:30:00,761967.2999999999,1635.4200000003912
Sell,177,4321.76,2021-10-31 06:45:00,764951.52,766586.9400000004
Buy,177,4321.76,2021-10-31 06:45:00,764951.52,1635.4200000003912
Sell,177,4325.92,2021-10-31 07:00:00,765687.84,767323.2600000004
Buy,177,4325.92,2021-10-31 07:00:00,765687.84,1635.4200000003912
Sell,177,4332.69,2021-10-31 07:15:00,766886.1299999999,768521.5500000003
Buy,177,4332.69,2021-10-31 07:15:00,766886.1299999999,1635.4200000003912
Sell,177,4322.78,2021-10-31 07:30:00,765132.0599999999,766767.4800000003
Buy,177,4322.78,2021-10-31 07:30:00,765132.0599999999,1635.4200000003912
Sell,177,4320.97,2021-10-31 07:45:00,764811.6900000001,766447.1100000005
Buy,177,4320.97,2021-10-31 07:45:00,764811.6900000001,1635.4200000003912
Sell,177,4307.77,2021-10-31 08:00:00,762475.29,764110.7100000004
Buy,177,4307.77,2021-10-31 08:00:00,762475.29,1635.4200000003912
Sell,177,4290.72,2021-10-31 08:15:00,759457.4400000001,761092.8600000005
Buy,177,4290.72,2021-10-31 08:15:00,759457.4400000001,1635.4200000003912
Sell,177,4268.0,2021-10-31 08:30:00,755436.0,757071.4200000004
Buy,177,4268.0,2021-10-31 08:30:00,755436.0,1635.4200000003912
Sell,177,4274.72,2021-10-31 08:45:00,756625.4400000001,758260.8600000005
Buy,177,4274.72,2021-10-31 08:45:00,756625.4400000001,1635.4200000003912
Sell,177,4259.24,2021-10-31 09:00:00,753885.48,755520.9000000004
Buy,177,4259.24,2021-10-31 09:00:00,753885.48,1635.4200000003912
Sell,177,4274.31,2021-10-31 09:15:00,756552.8700000001,758188.2900000005
Buy,177,4274.31,2021-10-31 09:15:00,756552.8700000001,1635.4200000003912
Sell,177,4263.82,2021-10-31 09:30:00,754696.1399999999,756331.5600000003
Buy,177,4263.82,2021-10-31 09:30:00,754696.1399999999,1635.4200000003912
Sell,177,4262.44,2021-10-31 09:45:00,754451.8799999999,756087.3000000003
Buy,177,4262.44,2021-10-31 09:45:00,754451.8799999999,1635.4200000003912
Sell,177,4243.5,2021-10-31 10:00:00,751099.5,752734.9200000004
Buy,177,4243.5,2021-10-31 10:00:00,751099.5,1635.4200000003912
Sell,177,4259.88,2021-10-31 10:15:00,753998.76,755634.1800000004
Buy,177,4259.88,2021-10-31 10:15:00,753998.76,1635.4200000003912
Sell,177,4281.59,2021-10-31 10:30:00,757841.43,759476.8500000004
Buy,177,4281.59,2021-10-31 10:30:00,757841.43,1635.4200000003912
Sell,177,4254.11,2021-10-31 10:45:00,752977.47,754612.8900000004
Buy,177,4254.11,2021-10-31 10:45:00,752977.47,1635.4200000003912
Sell,177,4250.99,2021-10-31 11:00:00,752425.23,754060.6500000004
Buy,177,4250.99,2021-10-31 11:00:00,752425.23,1635.4200000003912
Sell,177,4242.57,2021-10-31 11:15:00,750934.8899999999,752570.3100000003
Buy,177,4242.57,2021-10-31 11:15:00,750934.8899999999,1635.4200000003912
Sell,177,4210.15,2021-10-31 11:30:00,745196.5499999999,746831.9700000003
Buy,177,4210.15,2021-10-31 11:30:00,745196.5499999999,1635.4200000003912
Sell,177,4209.95,2021-10-31 11:45:00,745161.15,746796.5700000004
Buy,177,4209.95,2021-10-31 11:45:00,745161.15,1635.4200000003912
Sell,177,4205.23,2021-10-31 12:00:00,744325.71,745961.1300000004
Buy,177,4205.23,2021-10-31 12:00:00,744325.71,1635.4200000003912
Sell,177,4210.93,2021-10-31 12:15:00,745334.6100000001,746970.0300000005
Buy,177,4210.93,2021-10-31 12:15:00,745334.6100000001,1635.4200000003912
Sell,177,4196.02,2021-10-31 12:30:00,742695.54,744330.9600000004
Buy,177,4196.02,2021-10-31 12:30:00,742695.54,1635.4200000003912
Sell,177,4189.28,2021-10-31 12:45:00,741502.5599999999,743137.9800000003
Buy,177,4189.28,2021-10-31 12:45:00,741502.5599999999,1635.4200000003912
Sell,177,4215.38,2021-10-31 13:00:00,746122.26,747757.6800000004
Buy,177,4215.38,2021-10-31 13:00:00,746122.26,1635.4200000003912
Sell,177,4198.79,2021-10-31 13:15:00,743185.83,744821.2500000003
Buy,177,4198.79,2021-10-31 13:15:00,743185.83,1635.4200000003912
Sell,177,4206.47,2021-10-31 13:30:00,744545.1900000001,746180.6100000005
Buy,177,4206.47,2021-10-31 13:30:00,744545.1900000001,1635.4200000003912
Sell,177,4208.6,2021-10-31 13:45:00,744922.2000000001,746557.6200000005
Buy,177,4208.6,2021-10-31 13:45:00,744922.2000000001,1635.4200000003912
Sell,177,4218.96,2021-10-31 14:00:00,746755.92,748391.3400000004
Buy,177,4218.96,2021-10-31 14:00:00,746755.92,1635.4200000003912
Sell,177,4228.15,2021-10-31 14:15:00,748382.5499999999,750017.9700000003
Buy,177,4228.15,2021-10-31 14:15:00,748382.5499999999,1635.4200000003912
Sell,177,4200.9,2021-10-31 14:30:00,743559.2999999999,745194.7200000003
Buy,177,4200.9,2021-10-31 14:30:00,743559.2999999999,1635.4200000003912
Sell,177,4208.34,2021-10-31 14:45:00,744876.18,746511.6000000004
Buy,177,4208.34,2021-10-31 14:45:00,744876.18,1635.4200000003912
Sell,177,4218.32,2021-10-31 15:00:00,746642.6399999999,748278.0600000003
Buy,177,4218.32,2021-10-31 15:00:00,746642.6399999999,1635.4200000003912
Sell,177,4227.1,2021-10-31 15:15:00,748196.7000000001,749832.1200000005
Buy,177,4227.1,2021-10-31 15:15:00,748196.7000000001,1635.4200000003912
Sell,177,4214.64,2021-10-31 15:30:00,745991.28,747626.7000000004
Buy,177,4214.64,2021-10-31 15:30:00,745991.28,1635.4200000003912
Sell,177,4216.54,2021-10-31 15:45:00,746327.58,747963.0000000003
Buy,177,4216.54,2021-10-31 15:45:00,746327.58,1635.4200000003912
Sell,177,4199.7,2021-10-31 16:00:00,743346.9,744982.3200000004
Buy,177,4199.7,2021-10-31 16:00:00,743346.9,1635.4200000003912
Sell,177,4225.99,2021-10-31 16:15:00,748000.23,749635.6500000004
Buy,177,4225.99,2021-10-31 16:15:00,748000.23,1635.4200000003912
Sell,177,4229.74,2021-10-31 16:30:00,748663.98,750299.4000000004
Buy,177,4229.74,2021-10-31 16:30:00,748663.98,1635.4200000003912
Sell,177,4239.24,2021-10-31 16:45:00,750345.48,751980.9000000004
Buy,177,4239.24,2021-10-31 16:45:00,750345.48,1635.4200000003912
Sell,177,4238.01,2021-10-31 17:00:00,750127.77,751763.1900000004
Buy,177,4238.01,2021-10-31 17:00:00,750127.77,1635.4200000003912
Sell,177,4261.21,2021-10-31 17:15:00,754234.17,755869.5900000004
Buy,177,4261.21,2021-10-31 17:15:00,754234.17,1635.4200000003912
Sell,177,4248.99,2021-10-31 17:30:00,752071.23,753706.6500000004
Buy,177,4248.99,2021-10-31 17:30:00,752071.23,1635.4200000003912
Sell,177,4244.03,2021-10-31 17:45:00,751193.3099999999,752828.7300000003
Buy,177,4244.03,2021-10-31 17:45:00,751193.3099999999,1635.4200000003912
Sell,177,4232.03,2021-10-31 18:00:00,749069.3099999999,750704.7300000003
Buy,177,4232.03,2021-10-31 18:00:00,749069.3099999999,1635.4200000003912
Sell,177,4225.69,2021-10-31 18:15:00,747947.1299999999,749582.5500000003
Buy,177,4225.69,2021-10-31 18:15:00,747947.1299999999,1635.4200000003912
Sell,177,4240.38,2021-10-31 18:30:00,750547.26,752182.6800000004
Buy,177,4240.38,2021-10-31 18:30:00,750547.26,1635.4200000003912
Sell,177,4253.0,2021-10-31 18:45:00,752781.0,754416.4200000004
Buy,177,4253.0,2021-10-31 18:45:00,752781.0,1635.4200000003912
Sell,177,4256.44,2021-10-31 19:00:00,753389.8799999999,755025.3000000003
Buy,177,4256.44,2021-10-31 19:00:00,753389.8799999999,1635.4200000003912
Sell,177,4260.55,2021-10-31 19:15:00,754117.35,755752.7700000004
Buy,177,4260.55,2021-10-31 19:15:00,754117.35,1635.4200000003912
Sell,177,4252.62,2021-10-31 19:30:00,752713.74,754349.1600000004
Buy,177,4252.62,2021-10-31 19:30:00,752713.74,1635.4200000003912
Sell,177,4250.42,2021-10-31 19:45:00,752324.34,753959.7600000004
Buy,177,4250.42,2021-10-31 19:45:00,752324.34,1635.4200000003912
Sell,177,4257.88,2021-10-31 20:00:00,753644.76,755280.1800000004
Buy,177,4257.88,2021-10-31 20:00:00,753644.76,1635.4200000003912
Sell,177,4269.62,2021-10-31 20:15:00,755722.74,757358.1600000004
Buy,177,4269.62,2021-10-31 20:15:00,755722.74,1635.4200000003912
Sell,177,4269.84,2021-10-31 20:30:00,755761.68,757397.1000000004
Buy,177,4269.84,2021-10-31 20:30:00,755761.68,1635.4200000003912
Sell,177,4267.36,2021-10-31 20:45:00,755322.72,756958.1400000004
Buy,177,4267.36,2021-10-31 20:45:00,755322.72,1635.4200000003912
Sell,177,4270.65,2021-10-31 21:00:00,755905.0499999999,757540.4700000003
Buy,177,4270.65,2021-10-31 21:00:00,755905.0499999999,1635.4200000003912
Sell,177,4278.88,2021-10-31 21:15:00,757361.76,758997.1800000004
Buy,177,4278.88,2021-10-31 21:15:00,757361.76,1635.4200000003912
Sell,177,4313.81,2021-10-31 21:30:00,763544.3700000001,765179.7900000005
Buy,177,4313.81,2021-10-31 21:30:00,763544.3700000001,1635.4200000003912
Sell,177,4310.05,2021-10-31 21:45:00,762878.85,764514.2700000004
Buy,177,4310.05,2021-10-31 21:45:00,762878.85,1635.4200000003912
Sell,177,4298.51,2021-10-31 22:00:00,760836.27,762471.6900000004
Buy,177,4298.51,2021-10-31 22:00:00,760836.27,1635.4200000003912
Sell,177,4309.54,2021-10-31 22:15:00,762788.58,764424.0000000003
Buy,177,4309.54,2021-10-31 22:15:00,762788.58,1635.4200000003912
Sell,177,4300.72,2021-10-31 22:30:00,761227.4400000001,762862.8600000005
Buy,177,4300.72,2021-10-31 22:30:00,761227.4400000001,1635.4200000003912
Sell,177,4295.77,2021-10-31 22:45:00,760351.29,761986.7100000004
Buy,177,4295.77,2021-10-31 22:45:00,760351.29,1635.4200000003912
Sell,177,4281.19,2021-10-31 23:00:00,757770.6299999999,759406.0500000003
Buy,177,4281.19,2021-10-31 23:00:00,757770.6299999999,1635.4200000003912
Sell,177,4291.46,2021-10-31 23:15:00,759588.42,761223.8400000004
Buy,177,4291.46,2021-10-31 23:15:00,759588.42,1635.4200000003912
Sell,177,4297.77,2021-10-31 23:30:00,760705.29,762340.7100000004
Buy,177,4297.77,2021-10-31 23:30:00,760705.29,1635.4200000003912
Sell,177,4288.86,2021-10-31 23:45:00,759128.22,760763.6400000004
Buy,177,4288.86,2021-10-31 23:45:00,759128.22,1635.4200000003912
Sell,177,2484.77,2021-11-06 00:00:00,439804.29,441439.71000000037
Buy,139,3168.02,2021-11-08 01:00:00,440354.77999999997,1084.9300000004005
Sell,139,3183.84,2021-11-08 01:15:00,442553.76,443638.6900000004
Buy,139,3183.84,2021-11-08 01:15:00,442553.76,1084.9300000004005
Sell,139,3173.26,2021-11-08 01:30:00,441083.14,442168.0700000004
Buy,96,4605.32,2021-11-11 00:00:00,442110.72,57.35000000044238
Sell,96,4608.05,2021-11-11 00:15:00,442372.80000000005,442430.1500000005
Buy,96,4608.05,2021-11-11 00:15:00,442372.80000000005,57.35000000044238
Sell,96,4592.35,2021-11-11 00:30:00,440865.60000000003,440922.9500000005
Buy,96,4592.35,2021-11-11 00:30:00,440865.60000000003,57.35000000044238
Sell,96,4630.84,2021-11-11 00:45:00,444560.64,444617.99000000046
Buy,96,4630.84,2021-11-11 00:45:00,444560.64,57.35000000044238
Sell,96,4617.35,2021-11-11 01:00:00,443265.60000000003,443322.9500000005
Buy,96,4617.35,2021-11-11 01:00:00,443265.60000000003,57.35000000044238
Sell,96,4605.34,2021-11-11 01:15:00,442112.64,442169.99000000046
Buy,96,4605.34,2021-11-11 01:15:00,442112.64,57.35000000044238
Sell,96,4609.05,2021-11-11 01:30:00,442468.80000000005,442526.1500000005
Buy,96,4609.05,2021-11-11 01:30:00,442468.80000000005,57.35000000044238
Sell,96,4620.24,2021-11-11 01:45:00,443543.04,443600.3900000004
Buy,96,4620.24,2021-11-11 01:45:00,443543.04,57.35000000044238
Sell,96,4590.15,2021-11-11 02:00:00,440654.39999999997,440711.7500000004
Buy,96,4590.15,2021-11-11 02:00:00,440654.39999999997,57.35000000044238
Sell,96,4590.61,2021-11-11 02:15:00,440698.55999999994,440755.9100000004
Buy,96,4590.61,2021-11-11 02:15:00,440698.55999999994,57.35000000044238
Sell,96,4596.53,2021-11-11 02:30:00,441266.88,441324.23000000045
Buy,96,4596.53,2021-11-11 02:30:00,441266.88,57.35000000044238
Sell,96,4618.63,2021-11-11 02:45:00,443388.48,443445.8300000004
Buy,96,4618.63,2021-11-11 02:45:00,443388.48,57.35000000044238
Sell,96,4615.71,2021-11-11 03:00:00,443108.16000000003,443165.5100000005
Buy,96,4615.71,2021-11-11 03:00:00,443108.16000000003,57.35000000044238
Sell,96,4641.14,2021-11-11 03:15:00,445549.44000000006,445606.7900000005
Buy,96,4641.14,2021-11-11 03:15:00,445549.44000000006,57.35000000044238
Sell,96,4631.85,2021-11-11 03:30:00,444657.60000000003,444714.9500000005
Buy,96,4631.85,2021-11-11 03:30:00,444657.60000000003,57.35000000044238
Sell,96,4640.24,2021-11-11 03:45:00,445463.04,445520.3900000004
Buy,96,4640.24,2021-11-11 03:45:00,445463.04,57.35000000044238
Sell,96,4634.56,2021-11-11 04:00:00,444917.76,444975.11000000045
Buy,96,4634.56,2021-11-11 04:00:00,444917.76,57.35000000044238
Sell,96,4632.39,2021-11-11 04:15:00,444709.44000000006,444766.7900000005
Buy,96,4632.39,2021-11-11 04:15:00,444709.44000000006,57.35000000044238
Sell,96,4629.44,2021-11-11 04:30:00,444426.24,444483.59000000043
Buy,96,4629.44,2021-11-11 04:30:00,444426.24,57.35000000044238
Sell,96,4636.16,2021-11-11 04:45:00,445071.36,445128.7100000004
Buy,96,4636.16,2021-11-11 04:45:00,445071.36,57.35000000044238
Sell,96,4651.8,2021-11-11 05:00:00,446572.80000000005,446630.1500000005
Buy,96,4651.8,2021-11-11 05:00:00,446572.80000000005,57.35000000044238
Sell,96,4660.0,2021-11-11 05:15:00,447360.0,447417.35000000044
Buy,96,4660.0,2021-11-11 05:15:00,447360.0,57.35000000044238
Sell,96,4647.89,2021-11-11 05:30:00,446197.44000000006,446254.7900000005
Buy,96,4647.89,2021-11-11 05:30:00,446197.44000000006,57.35000000044238
Sell,96,4657.57,2021-11-11 05:45:00,447126.72,447184.0700000004
Buy,96,4657.57,2021-11-11 05:45:00,447126.72,57.35000000044238
Sell,96,4660.19,2021-11-11 06:00:00,447378.24,447435.59000000043
Buy,96,4660.19,2021-11-11 06:00:00,447378.24,57.35000000044238
Sell,96,4656.37,2021-11-11 06:15:00,447011.52,447068.87000000046
Buy,96,4656.37,2021-11-11 06:15:00,447011.52,57.35000000044238
Sell,96,4668.96,2021-11-11 06:30:00,448220.16000000003,448277.5100000005
Buy,96,4668.96,2021-11-11 06:30:00,448220.16000000003,57.35000000044238
Sell,96,4671.31,2021-11-11 06:45:00,448445.76,448503.11000000045
Buy,96,4671.31,2021-11-11 06:45:00,448445.76,57.35000000044238
Sell,96,4679.35,2021-11-11 07:00:00,449217.60000000003,449274.9500000005
Buy,96,4679.35,2021-11-11 07:00:00,449217.60000000003,57.35000000044238
Sell,96,4682.96,2021-11-11 07:15:00,449564.16000000003,449621.5100000005
Buy,96,4682.96,2021-11-11 07:15:00,449564.16000000003,57.35000000044238
Sell,96,4688.76,2021-11-11 07:30:00,450120.96,450178.31000000046
Buy,96,4688.76,2021-11-11 07:30:00,450120.96,57.35000000044238
Sell,96,4693.68,2021-11-11 07:45:00,450593.28,450650.63000000047
Buy,96,4693.68,2021-11-11 07:45:00,450593.28,57.35000000044238
Sell,96,4674.47,2021-11-11 08:00:00,448749.12,448806.47000000044
Buy,96,4674.47,2021-11-11 08:00:00,448749.12,57.35000000044238
Sell,96,4661.68,2021-11-11 08:15:00,447521.28,447578.63000000047
Buy,96,4661.68,2021-11-11 08:15:00,447521.28,57.35000000044238
Sell,96,4674.01,2021-11-11 08:30:00,448704.96,448762.31000000046
Buy,96,4674.01,2021-11-11 08:30:00,448704.96,57.35000000044238
Sell,96,4723.31,2021-11-11 08:45:00,453437.76,453495.11000000045
Buy,96,4723.31,2021-11-11 08:45:00,453437.76,57.35000000044238
Sell,96,4715.29,2021-11-11 09:00:00,452667.83999999997,452725.1900000004
Buy,96,4715.29,2021-11-11 09:00:00,452667.83999999997,57.35000000044238
Sell,96,4744.9,2021-11-11 09:15:00,455510.39999999997,455567.7500000004
Buy,96,4744.9,2021-11-11 09:15:00,455510.39999999997,57.35000000044238
Sell,96,4728.78,2021-11-11 09:30:00,453962.88,454020.23000000045
Buy,96,4728.78,2021-11-11 09:30:00,453962.88,57.35000000044238
Sell,96,4731.89,2021-11-11 09:45:00,454261.44000000006,454318.7900000005
Buy,96,4731.89,2021-11-11 09:45:00,454261.44000000006,57.35000000044238
Sell,96,4720.64,2021-11-11 10:00:00,453181.44000000006,453238.7900000005
Buy,96,4720.64,2021-11-11 10:00:00,453181.44000000006,57.35000000044238
Sell,96,4710.49,2021-11-11 10:15:00,452207.04,452264.3900000004
Buy,96,4710.49,2021-11-11 10:15:00,452207.04,57.35000000044238
Sell,96,4719.93,2021-11-11 10:30:00,453113.28,453170.63000000047
Buy,96,4719.93,2021-11-11 10:30:00,453113.28,57.35000000044238
Sell,96,4710.32,2021-11-11 10:45:00,452190.72,452248.0700000004
Buy,96,4710.32,2021-11-11 10:45:00,452190.72,57.35000000044238
Sell,96,4710.42,2021-11-11 11:00:00,452200.32,452257.67000000045
Buy,96,4710.42,2021-11-11 11:00:00,452200.32,57.35000000044238
Sell,96,4715.76,2021-11-11 11:15:00,452712.96,452770.31000000046
Buy,96,4715.76,2021-11-11 11:15:00,452712.96,57.35000000044238
Sell,96,4699.19,2021-11-11 11:30:00,451122.24,451179.59000000043
Buy,96,4699.19,2021-11-11 11:30:00,451122.24,57.35000000044238
Sell,96,4724.25,2021-11-11 11:45:00,453528.0,453585.35000000044
Buy,96,4724.25,2021-11-11 11:45:00,453528.0,57.35000000044238
Sell,96,4688.98,2021-11-11 12:00:00,450142.07999999996,450199.4300000004
Buy,96,4688.98,2021-11-11 12:00:00,450142.07999999996,57.35000000044238
Sell,96,4694.04,2021-11-11 12:15:00,450627.83999999997,450685.1900000004
Buy,96,4694.04,2021-11-11 12:15:00,450627.83999999997,57.35000000044238
Sell,96,4698.85,2021-11-11 12:30:00,451089.60000000003,451146.9500000005
Buy,96,4698.85,2021-11-11 12:30:00,451089.60000000003,57.35000000044238
Sell,96,4718.05,2021-11-11 12:45:00,452932.80000000005,452990.1500000005
Buy,96,4718.05,2021-11-11 12:45:00,452932.80000000005,57.35000000044238
Sell,96,4700.05,2021-11-11 13:00:00,451204.80000000005,451262.1500000005
Buy,96,4700.05,2021-11-11 13:00:00,451204.80000000005,57.35000000044238
Sell,96,4719.41,2021-11-11 13:15:00,453063.36,453120.7100000004
Buy,96,4719.41,2021-11-11 13:15:00,453063.36,57.35000000044238
Sell,96,4715.74,2021-11-11 13:30:00,452711.04,452768.3900000004
Buy,96,4715.74,2021-11-11 13:30:00,452711.04,57.35000000044238
Sell,96,4705.9,2021-11-11 13:45:00,451766.39999999997,451823.7500000004
Buy,96,4705.9,2021-11-11 13:45:00,451766.39999999997,57.35000000044238
Sell,96,4686.18,2021-11-11 14:00:00,449873.28,449930.63000000047
Buy,96,4686.18,2021-11-11 14:00:00,449873.28,57.35000000044238
Sell,96,4696.05,2021-11-11 14:15:00,450820.80000000005,450878.1500000005
Buy,96,4696.05,2021-11-11 14:15:00,450820.80000000005,57.35000000044238
Sell,96,4747.02,2021-11-11 14:30:00,455713.92000000004,455771.2700000005
Buy,96,4747.02,2021-11-11 14:30:00,455713.92000000004,57.35000000044238
Sell,96,4738.78,2021-11-11 14:45:00,454922.88,454980.23000000045
Buy,96,4738.78,2021-11-11 14:45:00,454922.88,57.35000000044238
Sell,96,4758.38,2021-11-11 15:00:00,456804.48,456861.8300000004
Buy,96,4758.38,2021-11-11 15:00:00,456804.48,57.35000000044238
Sell,96,4725.0,2021-11-11 15:15:00,453600.0,453657.35000000044
Buy,96,4725.0,2021-11-11 15:15:00,453600.0,57.35000000044238
Sell,96,4725.99,2021-11-11 15:30:00,453695.04,453752.3900000004
Buy,96,4725.99,2021-11-11 15:30:00,453695.04,57.35000000044238
Sell,96,4722.06,2021-11-11 15:45:00,453317.76,453375.11000000045
Buy,96,4722.06,2021-11-11 15:45:00,453317.76,57.35000000044238
Sell,96,4735.75,2021-11-11 16:00:00,454632.0,454689.35000000044
Buy,96,4735.75,2021-11-11 16:00:00,454632.0,57.35000000044238
Sell,96,4751.38,2021-11-11 16:15:00,456132.48,456189.8300000004
Buy,96,4751.38,2021-11-11 16:15:00,456132.48,57.35000000044238
Sell,96,4759.56,2021-11-11 16:30:00,456917.76,456975.11000000045
Buy,96,4759.56,2021-11-11 16:30:00,456917.76,57.35000000044238
Sell,96,4769.41,2021-11-11 16:45:00,457863.36,457920.7100000004
Buy,96,4769.41,2021-11-11 16:45:00,457863.36,57.35000000044238
Sell,96,4762.25,2021-11-11 17:00:00,457176.0,457233.35000000044
Buy,96,4762.25,2021-11-11 17:00:00,457176.0,57.35000000044238
Sell,96,4750.82,2021-11-11 17:15:00,456078.72,456136.0700000004
Buy,96,4750.82,2021-11-11 17:15:00,456078.72,57.35000000044238
Sell,96,4762.82,2021-11-11 17:30:00,457230.72,457288.0700000004
Buy,96,4762.82,2021-11-11 17:30:00,457230.72,57.35000000044238
Sell,96,4752.82,2021-11-11 17:45:00,456270.72,456328.0700000004
Buy,96,4752.82,2021-11-11 17:45:00,456270.72,57.35000000044238
Sell,96,4755.61,2021-11-11 18:00:00,456538.55999999994,456595.9100000004
Buy,96,4755.61,2021-11-11 18:00:00,456538.55999999994,57.35000000044238
Sell,96,4736.86,2021-11-11 18:15:00,454738.55999999994,454795.9100000004
Buy,96,4736.86,2021-11-11 18:15:00,454738.55999999994,57.35000000044238
Sell,96,4722.51,2021-11-11 18:30:00,453360.96,453418.31000000046
Buy,96,4722.51,2021-11-11 18:30:00,453360.96,57.35000000044238
Sell,96,4728.51,2021-11-11 18:45:00,453936.96,453994.31000000046
Buy,96,4728.51,2021-11-11 18:45:00,453936.96,57.35000000044238
Sell,96,4757.22,2021-11-11 19:00:00,456693.12,456750.47000000044
Buy,96,4757.22,2021-11-11 19:00:00,456693.12,57.35000000044238
Sell,96,4751.35,2021-11-11 19:15:00,456129.60000000003,456186.9500000005
Buy,96,4751.35,2021-11-11 19:15:00,456129.60000000003,57.35000000044238
Sell,96,4751.08,2021-11-11 19:30:00,456103.68,456161.03000000044
Buy,96,4751.08,2021-11-11 19:30:00,456103.68,57.35000000044238
Sell,96,4760.47,2021-11-11 19:45:00,457005.12,457062.47000000044
Buy,96,4760.47,2021-11-11 19:45:00,457005.12,57.35000000044238
Sell,96,4764.08,2021-11-11 20:00:00,457351.68,457409.03000000044
Buy,96,4764.08,2021-11-11 20:00:00,457351.68,57.35000000044238
Sell,96,4747.54,2021-11-11 20:15:00,455763.83999999997,455821.1900000004
Buy,96,4747.54,2021-11-11 20:15:00,455763.83999999997,57.35000000044238
Sell,96,4741.25,2021-11-11 20:30:00,455160.0,455217.35000000044
Buy,96,4741.25,2021-11-11 20:30:00,455160.0,57.35000000044238
Sell,96,4733.34,2021-11-11 20:45:00,454400.64,454457.99000000046
Buy,96,4733.34,2021-11-11 20:45:00,454400.64,57.35000000044238
Sell,96,4739.84,2021-11-11 21:00:00,455024.64,455081.99000000046
Buy,96,4739.84,2021-11-11 21:00:00,455024.64,57.35000000044238
Sell,96,4744.24,2021-11-11 21:15:00,455447.04,455504.3900000004
Buy,96,4744.24,2021-11-11 21:15:00,455447.04,57.35000000044238
Sell,96,4738.5,2021-11-11 21:30:00,454896.0,454953.35000000044
Buy,96,4738.5,2021-11-11 21:30:00,454896.0,57.35000000044238
Sell,96,4745.52,2021-11-11 21:45:00,455569.92000000004,455627.2700000005
Buy,96,4745.52,2021-11-11 21:45:00,455569.92000000004,57.35000000044238
Sell,96,4742.78,2021-11-11 22:00:00,455306.88,455364.23000000045
Buy,96,4742.78,2021-11-11 22:00:00,455306.88,57.35000000044238
Sell,96,4752.3,2021-11-11 22:15:00,456220.80000000005,456278.1500000005
Buy,96,4752.3,2021-11-11 22:15:00,456220.80000000005,57.35000000044238
Sell,96,4748.24,2021-11-11 22:30:00,455831.04,455888.3900000004
Buy,96,4748.24,2021-11-11 22:30:00,455831.04,57.35000000044238
Sell,96,4752.65,2021-11-11 22:45:00,456254.39999999997,456311.7500000004
Buy,96,4752.65,2021-11-11 22:45:00,456254.39999999997,57.35000000044238
Sell,96,4741.67,2021-11-11 23:00:00,455200.32,455257.67000000045
Buy,96,4741.67,2021-11-11 23:00:00,455200.32,57.35000000044238
Sell,96,4734.73,2021-11-11 23:15:00,454534.07999999996,454591.4300000004
Buy,96,4734.73,2021-11-11 23:15:00,454534.07999999996,57.35000000044238
Sell,96,4718.25,2021-11-11 23:30:00,452952.0,453009.35000000044
Buy,96,4718.25,2021-11-11 23:30:00,452952.0,57.35000000044238
Sell,96,4721.19,2021-11-11 23:45:00,453234.24,453291.59000000043
Buy,96,4721.19,2021-11-11 23:45:00,453234.24,57.35000000044238
Sell,96,3859.12,2021-11-12 00:00:00,370475.52,370532.87000000046
Buy,96,3859.12,2021-11-12 00:00:00,370475.52,57.35000000044238
Sell,96,3943.98,2021-11-12 00:15:00,378622.08,378679.43000000046
Buy,96,3943.98,2021-11-12 00:15:00,378622.08,57.35000000044238
Sell,96,3943.14,2021-11-12 00:30:00,378541.44,378598.79000000044
Buy,96,3943.14,2021-11-12 00:30:00,378541.44,57.35000000044238
Sell,96,3937.75,2021-11-12 00:45:00,378024.0,378081.35000000044
Buy,95,3960.57,2021-11-12 01:00:00,376254.15,1827.200000000419
Sell,95,3973.65,2021-11-12 01:15:00,377496.75,379323.9500000004
Buy,95,3982.54,2021-11-12 01:30:00,378341.3,982.6500000004307
Sell,95,3967.23,2021-11-12 01:45:00,376886.85,377869.5000000004
Buy,95,3967.23,2021-11-12 01:45:00,376886.85,982.6500000004307
Sell,95,3978.99,2021-11-12 02:00:00,378004.05,378986.7000000004
Buy,95,3978.99,2021-11-12 02:00:00,378004.05,982.6500000004307
Sell,95,3970.45,2021-11-12 02:15:00,377192.75,378175.40000000043
Buy,95,3970.45,2021-11-12 02:15:00,377192.75,982.6500000004307
Sell,95,3985.0,2021-11-12 02:30:00,378575.0,379557.65000000043
Buy,95,3985.0,2021-11-12 02:30:00,378575.0,982.6500000004307
Sell,95,3988.18,2021-11-12 02:45:00,378877.1,379859.7500000004
Buy,95,3988.18,2021-11-12 02:45:00,378877.1,982.6500000004307
Sell,95,4010.99,2021-11-12 03:00:00,381044.05,382026.7000000004
Buy,95,4010.99,2021-11-12 03:00:00,381044.05,982.6500000004307
Sell,95,4018.18,2021-11-12 03:15:00,381727.1,382709.7500000004
Buy,95,4018.18,2021-11-12 03:15:00,381727.1,982.6500000004307
Sell,95,4012.69,2021-11-12 03:30:00,381205.55,382188.2000000004
Buy,95,4012.69,2021-11-12 03:30:00,381205.55,982.6500000004307
Sell,95,4007.43,2021-11-12 03:45:00,380705.85,381688.5000000004
Buy,95,4007.43,2021-11-12 03:45:00,380705.85,982.6500000004307
Sell,95,4033.98,2021-11-12 04:00:00,383228.1,384210.7500000004
Buy,95,4033.98,2021-11-12 04:00:00,383228.1,982.6500000004307
Sell,95,4022.66,2021-11-12 04:15:00,382152.7,383135.35000000044
Buy,95,4022.66,2021-11-12 04:15:00,382152.7,982.6500000004307
Sell,95,4021.7,2021-11-12 04:30:00,382061.5,383044.15000000043
Buy,95,4021.7,2021-11-12 04:30:00,382061.5,982.6500000004307
Sell,95,4031.01,2021-11-12 04:45:00,382945.95,383928.60000000044
Buy,95,4031.01,2021-11-12 04:45:00,382945.95,982.6500000004307
Sell,95,4024.64,2021-11-12 05:00:00,382340.8,383323.4500000004
Buy,95,4024.64,2021-11-12 05:00:00,382340.8,982.6500000004307
Sell,95,4034.18,2021-11-12 05:15:00,383247.1,384229.7500000004
Buy,95,4034.18,2021-11-12 05:15:00,383247.1,982.6500000004307
Sell,95,4035.9,2021-11-12 05:30:00,383410.5,384393.15000000043
Buy,95,4035.9,2021-11-12 05:30:00,383410.5,982.6500000004307
Sell,95,4029.08,2021-11-12 05:45:00,382762.6,383745.2500000004
Buy,95,4029.08,2021-11-12 05:45:00,382762.6,982.6500000004307
Sell,95,4048.51,2021-11-12 06:00:00,384608.45,385591.10000000044
Buy,95,4048.51,2021-11-12 06:00:00,384608.45,982.6500000004307
Sell,95,4006.45,2021-11-12 06:15:00,380612.75,381595.40000000043
Buy,95,4006.45,2021-11-12 06:15:00,380612.75,982.6500000004307
Sell,95,3998.98,2021-11-12 06:30:00,379903.1,380885.7500000004
Buy,95,3998.98,2021-11-12 06:30:00,379903.1,982.6500000004307
Sell,95,3960.72,2021-11-12 06:45:00,376268.39999999997,377251.0500000004
Buy,95,3960.72,2021-11-12 06:45:00,376268.39999999997,982.6500000004307
Sell,95,3974.78,2021-11-12 07:00:00,377604.10000000003,378586.75000000047
Buy,95,3974.78,2021-11-12 07:00:00,377604.10000000003,982.6500000004307
Sell,95,3967.5,2021-11-12 07:15:00,376912.5,377895.15000000043
Buy,95,3967.5,2021-11-12 07:15:00,376912.5,982.6500000004307
Sell,95,3970.61,2021-11-12 07:30:00,377207.95,378190.60000000044
Buy,95,3970.61,2021-11-12 07:30:00,377207.95,982.6500000004307
Sell,95,3976.68,2021-11-12 07:45:00,377784.6,378767.2500000004
Buy,95,3976.68,2021-11-12 07:45:00,377784.6,982.6500000004307
Sell,95,3987.75,2021-11-12 08:00:00,378836.25,379818.90000000043
Buy,95,3987.75,2021-11-12 08:00:00,378836.25,982.6500000004307
Sell,95,4057.41,2021-11-12 08:15:00,385453.95,386436.60000000044
Buy,95,4057.41,2021-11-12 08:15:00,385453.95,982.6500000004307
Sell,95,4050.7,2021-11-12 08:30:00,384816.5,385799.15000000043
Buy,95,4050.7,2021-11-12 08:30:00,384816.5,982.6500000004307
Sell,95,4019.83,2021-11-12 08:45:00,381883.85,382866.5000000004
Buy,95,4019.83,2021-11-12 08:45:00,381883.85,982.6500000004307
Sell,95,3989.05,2021-11-12 09:00:00,378959.75,379942.40000000043
Buy,95,3989.05,2021-11-12 09:00:00,378959.75,982.6500000004307
Sell,95,4007.9,2021-11-12 09:15:00,380750.5,381733.15000000043
Buy,95,4007.9,2021-11-12 09:15:00,380750.5,982.6500000004307
Sell,95,4015.86,2021-11-12 09:30:00,381506.7,382489.35000000044
Buy,95,4015.86,2021-11-12 09:30:00,381506.7,982.6500000004307
Sell,95,4012.14,2021-11-12 09:45:00,381153.3,382135.9500000004
Buy,95,4012.14,2021-11-12 09:45:00,381153.3,982.6500000004307
Sell,95,4008.08,2021-11-12 10:00:00,380767.6,381750.2500000004
Buy,95,4008.08,2021-11-12 10:00:00,380767.6,982.6500000004307
Sell,95,4024.28,2021-11-12 10:15:00,382306.60000000003,383289.25000000047
Buy,95,4024.28,2021-11-12 10:15:00,382306.60000000003,982.6500000004307
Sell,95,4029.17,2021-11-12 10:30:00,382771.15,383753.80000000045
Buy,95,4029.17,2021-11-12 10:30:00,382771.15,982.6500000004307
Sell,95,4020.09,2021-11-12 10:45:00,381908.55,382891.2000000004
Buy,95,4020.09,2021-11-12 10:45:00,381908.55,982.6500000004307
Sell,95,4027.62,2021-11-12 11:00:00,382623.89999999997,383606.5500000004
Buy,95,4027.62,2021-11-12 11:00:00,382623.89999999997,982.6500000004307
Sell,95,4011.45,2021-11-12 11:15:00,381087.75,382070.40000000043
Buy,95,4011.45,2021-11-12 11:15:00,381087.75,982.6500000004307
Sell,95,4016.28,2021-11-12 11:30:00,381546.60000000003,382529.25000000047
Buy,95,4016.28,2021-11-12 11:30:00,381546.60000000003,982.6500000004307
Sell,95,4012.36,2021-11-12 11:45:00,381174.2,382156.85000000044
Buy,95,4012.36,2021-11-12 11:45:00,381174.2,982.6500000004307
Sell,95,4021.46,2021-11-12 12:00:00,382038.7,383021.35000000044
Buy,95,4021.46,2021-11-12 12:00:00,382038.7,982.6500000004307
Sell,95,4032.27,2021-11-12 12:15:00,383065.65,384048.30000000045
Buy,95,4032.27,2021-11-12 12:15:00,383065.65,982.6500000004307
Sell,95,4047.14,2021-11-12 12:30:00,384478.3,385460.9500000004
Buy,95,4047.14,2021-11-12 12:30:00,384478.3,982.6500000004307
Sell,95,4036.37,2021-11-12 12:45:00,383455.14999999997,384437.8000000004
Buy,95,4036.37,2021-11-12 12:45:00,383455.14999999997,982.6500000004307
Sell,95,4012.7,2021-11-12 13:00:00,381206.5,382189.15000000043
Buy,95,4012.7,2021-11-12 13:00:00,381206.5,982.6500000004307
Sell,95,4023.98,2021-11-12 13:15:00,382278.1,383260.7500000004
Buy,95,4023.98,2021-11-12 13:15:00,382278.1,982.6500000004307
Sell,95,4015.63,2021-11-12 13:30:00,381484.85000000003,382467.50000000047
Buy,95,4015.63,2021-11-12 13:30:00,381484.85000000003,982.6500000004307
Sell,95,4008.76,2021-11-12 13:45:00,380832.2,381814.85000000044
Buy,95,4008.76,2021-11-12 13:45:00,380832.2,982.6500000004307
Sell,95,4005.64,2021-11-12 14:00:00,380535.8,381518.4500000004
Buy,95,4005.64,2021-11-12 14:00:00,380535.8,982.6500000004307
Sell,95,4009.17,2021-11-12 14:15:00,380871.15,381853.80000000045
Buy,95,4009.17,2021-11-12 14:15:00,380871.15,982.6500000004307
Sell,95,4022.62,2021-11-12 14:30:00,382148.89999999997,383131.5500000004
Buy,95,4022.62,2021-11-12 14:30:00,382148.89999999997,982.6500000004307
Sell,95,4026.73,2021-11-12 14:45:00,382539.35,383522.0000000004
Buy,95,4026.73,2021-11-12 14:45:00,382539.35,982.6500000004307
Sell,95,4023.72,2021-11-12 15:00:00,382253.39999999997,383236.0500000004
Buy,95,4023.72,2021-11-12 15:00:00,382253.39999999997,982.6500000004307
Sell,95,4037.46,2021-11-12 15:15:00,383558.7,384541.35000000044
Buy,95,4037.46,2021-11-12 15:15:00,383558.7,982.6500000004307
Sell,95,4039.31,2021-11-12 15:30:00,383734.45,384717.10000000044
Buy,95,4039.31,2021-11-12 15:30:00,383734.45,982.6500000004307
Sell,95,4056.69,2021-11-12 15:45:00,385385.55,386368.2000000004
Buy,95,4056.69,2021-11-12 15:45:00,385385.55,982.6500000004307
Sell,95,4070.28,2021-11-12 16:00:00,386676.60000000003,387659.25000000047
Buy,95,4070.28,2021-11-12 16:00:00,386676.60000000003,982.6500000004307
Sell,95,4081.07,2021-11-12 16:15:00,387701.65,388684.30000000045
Buy,95,4081.07,2021-11-12 16:15:00,387701.65,982.6500000004307
Sell,95,4088.33,2021-11-12 16:30:00,388391.35,389374.0000000004
Buy,95,4088.33,2021-11-12 16:30:00,388391.35,982.6500000004307
Sell,95,4073.5,2021-11-12 16:45:00,386982.5,387965.15000000043
Buy,95,4073.5,2021-11-12 16:45:00,386982.5,982.6500000004307
Sell,95,4064.27,2021-11-12 17:00:00,386105.65,387088.30000000045
Buy,95,4064.27,2021-11-12 17:00:00,386105.65,982.6500000004307
Sell,95,4065.12,2021-11-12 17:15:00,386186.39999999997,387169.0500000004
Buy,95,4065.12,2021-11-12 17:15:00,386186.39999999997,982.6500000004307
Sell,95,4053.0,2021-11-12 17:30:00,385035.0,386017.65000000043
Buy,95,4053.0,2021-11-12 17:30:00,385035.0,982.6500000004307
Sell,95,4043.97,2021-11-12 17:45:00,384177.14999999997,385159.8000000004
Buy,95,4043.97,2021-11-12 17:45:00,384177.14999999997,982.6500000004307
Sell,95,4030.01,2021-11-12 18:00:00,382850.95,383833.60000000044
Buy,95,4030.01,2021-11-12 18:00:00,382850.95,982.6500000004307
Sell,95,4028.55,2021-11-12 18:15:00,382712.25,383694.90000000043
Buy,95,4028.55,2021-11-12 18:15:00,382712.25,982.6500000004307
Sell,95,4039.2,2021-11-12 18:30:00,383724.0,384706.65000000043
Buy,95,4039.2,2021-11-12 18:30:00,383724.0,982.6500000004307
Sell,95,4037.0,2021-11-12 18:45:00,383515.0,384497.65000000043
Buy,95,4037.0,2021-11-12 18:45:00,383515.0,982.6500000004307
Sell,95,4037.21,2021-11-12 19:00:00,383534.95,384517.60000000044
Buy,95,4037.21,2021-11-12 19:00:00,383534.95,982.6500000004307
Sell,95,4034.32,2021-11-12 19:15:00,383260.4,384243.05000000045
Buy,95,4034.32,2021-11-12 19:15:00,383260.4,982.6500000004307
Sell,95,4012.84,2021-11-12 19:30:00,381219.8,382202.4500000004
Buy,95,4012.84,2021-11-12 19:30:00,381219.8,982.6500000004307
Sell,95,4002.41,2021-11-12 19:45:00,380228.95,381211.60000000044
Buy,95,4002.41,2021-11-12 19:45:00,380228.95,982.6500000004307
Sell,95,4012.36,2021-11-12 20:00:00,381174.2,382156.85000000044
Buy,95,4012.36,2021-11-12 20:00:00,381174.2,982.6500000004307
Sell,95,4019.17,2021-11-12 20:15:00,381821.15,382803.80000000045
Buy,95,4019.17,2021-11-12 20:15:00,381821.15,982.6500000004307
Sell,95,4033.65,2021-11-12 20:30:00,383196.75,384179.40000000043
Buy,95,4033.65,2021-11-12 20:30:00,383196.75,982.6500000004307
Sell,95,4013.04,2021-11-12 20:45:00,381238.8,382221.4500000004
Buy,95,4013.04,2021-11-12 20:45:00,381238.8,982.6500000004307
Sell,95,4006.93,2021-11-12 21:00:00,380658.35,381641.0000000004
Buy,95,4006.93,2021-11-12 21:00:00,380658.35,982.6500000004307
Sell,95,4007.5,2021-11-12 21:15:00,380712.5,381695.15000000043
Buy,95,4007.5,2021-11-12 21:15:00,380712.5,982.6500000004307
Sell,95,3995.25,2021-11-12 21:30:00,379548.75,380531.40000000043
Buy,95,3995.25,2021-11-12 21:30:00,379548.75,982.6500000004307
Sell,95,4026.18,2021-11-12 21:45:00,382487.1,383469.7500000004
Buy,95,4026.18,2021-11-12 21:45:00,382487.1,982.6500000004307
Sell,95,4017.85,2021-11-12 22:00:00,381695.75,382678.40000000043
Buy,95,4017.85,2021-11-12 22:00:00,381695.75,982.6500000004307
Sell,95,4019.24,2021-11-12 22:15:00,381827.8,382810.4500000004
Buy,95,4019.24,2021-11-12 22:15:00,381827.8,982.6500000004307
Sell,95,4061.42,2021-11-12 22:30:00,385834.9,386817.55000000045
Buy,95,4061.42,2021-11-12 22:30:00,385834.9,982.6500000004307
Sell,95,4023.25,2021-11-12 22:45:00,382208.75,383191.40000000043
Buy,95,4023.25,2021-11-12 22:45:00,382208.75,982.6500000004307
Sell,95,4044.0,2021-11-12 23:00:00,384180.0,385162.65000000043
Buy,95,4044.0,2021-11-12 23:00:00,384180.0,982.6500000004307
Sell,95,4080.0,2021-11-12 23:15:00,387600.0,388582.65000000043
Buy,95,4080.0,2021-11-12 23:15:00,387600.0,982.6500000004307
Sell,95,4084.59,2021-11-12 23:30:00,388036.05,389018.7000000004
Buy,95,4084.59,2021-11-12 23:30:00,388036.05,982.6500000004307
Sell,95,4089.81,2021-11-12 23:45:00,388531.95,389514.60000000044
Buy,95,4089.81,2021-11-12 23:45:00,388531.95,982.6500000004307
Sell,95,4699.5,2021-11-13 00:00:00,446452.5,447435.15000000043
Buy,95,4699.5,2021-11-13 00:00:00,446452.5,982.6500000004307
Sell,95,4684.31,2021-11-13 00:15:00,445009.45,445992.10000000044
Buy,95,4684.31,2021-11-13 00:15:00,445009.45,982.6500000004307
Sell,95,4692.83,2021-11-13 00:30:00,445818.85,446801.5000000004
Buy,95,4692.83,2021-11-13 00:30:00,445818.85,982.6500000004307
Sell,95,4688.16,2021-11-13 00:45:00,445375.2,446357.85000000044
Buy,95,4688.16,2021-11-13 00:45:00,445375.2,982.6500000004307
Sell,95,4681.25,2021-11-13 01:00:00,444718.75,445701.40000000043
Buy,95,4681.25,2021-11-13 01:00:00,444718.75,982.6500000004307
Sell,95,4666.84,2021-11-13 01:15:00,443349.8,444332.4500000004
Buy,95,4666.84,2021-11-13 01:15:00,443349.8,982.6500000004307
Sell,95,4655.29,2021-11-13 01:30:00,442252.55,443235.2000000004
Buy,95,4655.29,2021-11-13 01:30:00,442252.55,982.6500000004307
Sell,95,4631.19,2021-11-13 01:45:00,439963.05,440945.7000000004
Buy,95,4631.19,2021-11-13 01:45:00,439963.05,982.6500000004307
Sell,95,4634.66,2021-11-13 02:00:00,440292.7,441275.35000000044
Buy,95,4634.66,2021-11-13 02:00:00,440292.7,982.6500000004307
Sell,95,4638.06,2021-11-13 02:15:00,440615.7,441598.35000000044
Buy,95,4638.06,2021-11-13 02:15:00,440615.7,982.6500000004307
Sell,95,4645.41,2021-11-13 02:30:00,441313.95,442296.60000000044
Buy,95,4645.41,2021-11-13 02:30:00,441313.95,982.6500000004307
Sell,95,4629.87,2021-11-13 02:45:00,439837.64999999997,440820.3000000004
Buy,95,4629.87,2021-11-13 02:45:00,439837.64999999997,982.6500000004307
Sell,95,4638.58,2021-11-13 03:00:00,440665.1,441647.7500000004
Buy,95,4638.58,2021-11-13 03:00:00,440665.1,982.6500000004307
Sell,95,4641.28,2021-11-13 03:15:00,440921.6,441904.2500000004
Buy,95,4641.28,2021-11-13 03:15:00,440921.6,982.6500000004307
Sell,95,4639.96,2021-11-13 03:30:00,440796.2,441778.85000000044
Buy,95,4639.96,2021-11-13 03:30:00,440796.2,982.6500000004307
Sell,95,4639.2,2021-11-13 03:45:00,440724.0,441706.65000000043
Buy,95,4639.2,2021-11-13 03:45:00,440724.0,982.6500000004307
Sell,95,4629.48,2021-11-13 04:00:00,439800.6,440783.2500000004
Buy,95,4629.48,2021-11-13 04:00:00,439800.6,982.6500000004307
Sell,95,4633.6,2021-11-13 04:15:00,440192.00000000006,441174.6500000005
Buy,95,4633.6,2021-11-13 04:15:00,440192.00000000006,982.6500000004307
Sell,95,4631.08,2021-11-13 04:30:00,439952.6,440935.2500000004
Buy,95,4631.08,2021-11-13 04:30:00,439952.6,982.6500000004307
Sell,95,4621.9,2021-11-13 04:45:00,439080.49999999994,440063.1500000004
Buy,95,4621.9,2021-11-13 04:45:00,439080.49999999994,982.6500000004307
Sell,95,4618.1,2021-11-13 05:00:00,438719.50000000006,439702.1500000005
Buy,95,4618.1,2021-11-13 05:00:00,438719.50000000006,982.6500000004307
Sell,95,4623.07,2021-11-13 05:15:00,439191.64999999997,440174.3000000004
Buy,95,4623.07,2021-11-13 05:15:00,439191.64999999997,982.6500000004307
Sell,95,4621.23,2021-11-13 05:30:00,439016.85,439999.5000000004
Buy,95,4621.23,2021-11-13 05:30:00,439016.85,982.6500000004307
Sell,95,4618.41,2021-11-13 05:45:00,438748.95,439731.60000000044
Buy,95,4618.41,2021-11-13 05:45:00,438748.95,982.6500000004307
Sell,95,4623.45,2021-11-13 06:00:00,439227.75,440210.40000000043
Buy,95,4623.45,2021-11-13 06:00:00,439227.75,982.6500000004307
Sell,95,4638.79,2021-11-13 06:15:00,440685.05,441667.7000000004
Buy,95,4638.79,2021-11-13 06:15:00,440685.05,982.6500000004307
Sell,95,4634.89,2021-11-13 06:30:00,440314.55000000005,441297.2000000005
Buy,95,4634.89,2021-11-13 06:30:00,440314.55000000005,982.6500000004307
Sell,95,4647.38,2021-11-13 06:45:00,441501.10000000003,442483.75000000047
Buy,95,4647.38,2021-11-13 06:45:00,441501.10000000003,982.6500000004307
Sell,95,4641.65,2021-11-13 07:00:00,440956.74999999994,441939.4000000004
Buy,95,4641.65,2021-11-13 07:00:00,440956.74999999994,982.6500000004307
Sell,95,4636.44,2021-11-13 07:15:00,440461.8,441444.4500000004
Buy,95,4636.44,2021-11-13 07:15:00,440461.8,982.6500000004307
Sell,95,4627.39,2021-11-13 07:30:00,439602.05000000005,440584.7000000005
Buy,95,4627.39,2021-11-13 07:30:00,439602.05000000005,982.6500000004307
Sell,95,4646.16,2021-11-13 07:45:00,441385.2,442367.85000000044
Buy,95,4646.16,2021-11-13 07:45:00,441385.2,982.6500000004307
Sell,95,4640.13,2021-11-13 08:00:00,440812.35000000003,441795.00000000047
Buy,95,4640.13,2021-11-13 08:00:00,440812.35000000003,982.6500000004307
Sell,95,4636.06,2021-11-13 08:15:00,440425.7,441408.35000000044
Buy,95,4636.06,2021-11-13 08:15:00,440425.7,982.6500000004307
Sell,95,4622.01,2021-11-13 08:30:00,439090.95,440073.60000000044
Buy,95,4622.01,2021-11-13 08:30:00,439090.95,982.6500000004307
Sell,95,4625.49,2021-11-13 08:45:00,439421.55,440404.2000000004
Buy,95,4625.49,2021-11-13 08:45:00,439421.55,982.6500000004307
Sell,95,4607.05,2021-11-13 09:00:00,437669.75,438652.40000000043
Buy,95,4607.05,2021-11-13 09:00:00,437669.75,982.6500000004307
Sell,95,4608.18,2021-11-13 09:15:00,437777.10000000003,438759.75000000047
Buy,95,4608.18,2021-11-13 09:15:00,437777.10000000003,982.6500000004307
Sell,95,4599.18,2021-11-13 09:30:00,436922.10000000003,437904.75000000047
Buy,95,4599.18,2021-11-13 09:30:00,436922.10000000003,982.6500000004307
Sell,95,4593.44,2021-11-13 09:45:00,436376.8,437359.4500000004
Buy,95,4593.44,2021-11-13 09:45:00,436376.8,982.6500000004307
Sell,95,4606.84,2021-11-13 10:00:00,437649.8,438632.4500000004
Buy,95,4606.84,2021-11-13 10:00:00,437649.8,982.6500000004307
Sell,95,4597.39,2021-11-13 10:15:00,436752.05000000005,437734.7000000005
Buy,95,4597.39,2021-11-13 10:15:00,436752.05000000005,982.6500000004307
Sell,95,4613.54,2021-11-13 10:30:00,438286.3,439268.9500000004
Buy,95,4613.54,2021-11-13 10:30:00,438286.3,982.6500000004307
Sell,95,4614.96,2021-11-13 10:45:00,438421.2,439403.85000000044
Buy,95,4614.96,2021-11-13 10:45:00,438421.2,982.6500000004307
Sell,95,4618.21,2021-11-13 11:00:00,438729.95,439712.60000000044
Buy,95,4618.21,2021-11-13 11:00:00,438729.95,982.6500000004307
Sell,95,4615.29,2021-11-13 11:15:00,438452.55,439435.2000000004
Buy,95,4615.29,2021-11-13 11:15:00,438452.55,982.6500000004307
Sell,95,4603.62,2021-11-13 11:30:00,437343.89999999997,438326.5500000004
Buy,95,4603.62,2021-11-13 11:30:00,437343.89999999997,982.6500000004307
Sell,95,4616.86,2021-11-13 12:00:00,438601.69999999995,439584.3500000004
Buy,95,4616.86,2021-11-13 12:00:00,438601.69999999995,982.6500000004307
Sell,95,4615.11,2021-11-13 12:15:00,438435.44999999995,439418.1000000004
Buy,95,4615.11,2021-11-13 12:15:00,438435.44999999995,982.6500000004307
Sell,95,4605.05,2021-11-13 12:30:00,437479.75,438462.40000000043
Buy,95,4605.05,2021-11-13 12:30:00,437479.75,982.6500000004307
Sell,95,4603.88,2021-11-13 12:45:00,437368.60000000003,438351.25000000047
Buy,95,4603.88,2021-11-13 12:45:00,437368.60000000003,982.6500000004307
Sell,95,4620.8,2021-11-13 13:00:00,438976.0,439958.65000000043
Buy,95,4620.8,2021-11-13 13:00:00,438976.0,982.6500000004307
Sell,95,4612.48,2021-11-13 13:15:00,438185.6,439168.2500000004
Buy,95,4612.48,2021-11-13 13:15:00,438185.6,982.6500000004307
Sell,95,4607.43,2021-11-13 13:30:00,437705.85000000003,438688.50000000047
Buy,95,4607.43,2021-11-13 13:30:00,437705.85000000003,982.6500000004307
Sell,95,4617.02,2021-11-13 13:45:00,438616.9,439599.55000000045
Buy,95,4617.02,2021-11-13 13:45:00,438616.9,982.6500000004307
Sell,95,4661.24,2021-11-13 14:00:00,442817.8,443800.4500000004
Buy,95,4661.24,2021-11-13 14:00:00,442817.8,982.6500000004307
Sell,95,4674.81,2021-11-13 14:15:00,444106.95,445089.60000000044
Buy,95,4674.81,2021-11-13 14:15:00,444106.95,982.6500000004307
Sell,95,4683.59,2021-11-13 14:30:00,444941.05,445923.7000000004
Buy,95,4683.59,2021-11-13 14:30:00,444941.05,982.6500000004307
Sell,95,4672.82,2021-11-13 14:45:00,443917.89999999997,444900.5500000004
Buy,95,4672.82,2021-11-13 14:45:00,443917.89999999997,982.6500000004307
Sell,95,4674.16,2021-11-13 15:00:00,444045.2,445027.85000000044
Buy,95,4674.16,2021-11-13 15:00:00,444045.2,982.6500000004307
Sell,95,4685.63,2021-11-13 15:15:00,445134.85000000003,446117.50000000047
Buy,95,4685.63,2021-11-13 15:15:00,445134.85000000003,982.6500000004307
Sell,95,4681.35,2021-11-13 15:45:00,444728.25000000006,445710.9000000005
Buy,95,4681.35,2021-11-13 15:45:00,444728.25000000006,982.6500000004307
Sell,95,4686.34,2021-11-13 16:00:00,445202.3,446184.9500000004
Buy,95,4686.34,2021-11-13 16:00:00,445202.3,982.6500000004307
Sell,95,4677.05,2021-11-13 16:15:00,444319.75,445302.40000000043
Buy,95,4677.05,2021-11-13 16:15:00,444319.75,982.6500000004307
Sell,95,4685.35,2021-11-13 16:30:00,445108.25000000006,446090.9000000005
Buy,95,4685.35,2021-11-13 16:30:00,445108.25000000006,982.6500000004307
Sell,95,4677.12,2021-11-13 16:45:00,444326.39999999997,445309.0500000004
Buy,95,4677.12,2021-11-13 16:45:00,444326.39999999997,982.6500000004307
Sell,95,4674.11,2021-11-13 17:00:00,444040.44999999995,445023.1000000004
Buy,95,4674.11,2021-11-13 17:00:00,444040.44999999995,982.6500000004307
Sell,95,4672.85,2021-11-13 17:15:00,443920.75000000006,444903.4000000005
Buy,95,4672.85,2021-11-13 17:15:00,443920.75000000006,982.6500000004307
Sell,95,4680.5,2021-11-13 17:30:00,444647.5,445630.15000000043
Buy,95,4680.5,2021-11-13 17:30:00,444647.5,982.6500000004307
Sell,95,4689.46,2021-11-13 17:45:00,445498.7,446481.35000000044
Buy,95,4689.46,2021-11-13 17:45:00,445498.7,982.6500000004307
Sell,95,4677.78,2021-11-13 18:00:00,444389.1,445371.7500000004
Buy,95,4677.78,2021-11-13 18:00:00,444389.1,982.6500000004307
Sell,95,4674.9,2021-11-13 18:15:00,444115.49999999994,445098.1500000004
Buy,95,4674.9,2021-11-13 18:15:00,444115.49999999994,982.6500000004307
Sell,95,4656.75,2021-11-13 18:30:00,442391.25,443373.90000000043
Buy,95,4656.75,2021-11-13 18:30:00,442391.25,982.6500000004307
Sell,95,4654.96,2021-11-13 18:45:00,442221.2,443203.85000000044
Buy,95,4654.96,2021-11-13 18:45:00,442221.2,982.6500000004307
Sell,95,4630.74,2021-11-13 19:00:00,439920.3,440902.9500000004
Buy,95,4630.74,2021-11-13 19:00:00,439920.3,982.6500000004307
Sell,95,4642.98,2021-11-13 19:15:00,441083.1,442065.7500000004
Buy,95,4642.98,2021-11-13 19:15:00,441083.1,982.6500000004307
Sell,95,4646.47,2021-11-13 19:30:00,441414.65,442397.30000000045
Buy,95,4646.47,2021-11-13 19:30:00,441414.65,982.6500000004307
Sell,95,4645.06,2021-11-13 19:45:00,441280.7,442263.35000000044
Buy,95,4645.06,2021-11-13 19:45:00,441280.7,982.6500000004307
Sell,95,4648.73,2021-11-13 20:00:00,441629.35,442612.0000000004
Buy,95,4648.73,2021-11-13 20:00:00,441629.35,982.6500000004307
Sell,95,4643.04,2021-11-13 20:15:00,441088.8,442071.4500000004
Buy,95,4643.04,2021-11-13 20:15:00,441088.8,982.6500000004307
Sell,95,4647.49,2021-11-13 20:30:00,441511.55,442494.2000000004
Buy,95,4647.49,2021-11-13 20:30:00,441511.55,982.6500000004307
Sell,95,4661.59,2021-11-13 20:45:00,442851.05,443833.7000000004
Buy,95,4661.59,2021-11-13 20:45:00,442851.05,982.6500000004307
Sell,95,4655.04,2021-11-13 21:00:00,442228.8,443211.4500000004
Buy,95,4655.04,2021-11-13 21:00:00,442228.8,982.6500000004307
Sell,95,4659.99,2021-11-13 21:15:00,442699.05,443681.7000000004
Buy,95,4659.99,2021-11-13 21:15:00,442699.05,982.6500000004307
Sell,95,4648.37,2021-11-13 21:30:00,441595.14999999997,442577.8000000004
Buy,95,4648.37,2021-11-13 21:30:00,441595.14999999997,982.6500000004307
Sell,95,4657.66,2021-11-13 21:45:00,442477.7,443460.35000000044
Buy,95,4657.66,2021-11-13 21:45:00,442477.7,982.6500000004307
Sell,95,4656.61,2021-11-13 22:00:00,442377.94999999995,443360.6000000004
Buy,95,4656.61,2021-11-13 22:00:00,442377.94999999995,982.6500000004307
Sell,95,4654.21,2021-11-13 22:15:00,442149.95,443132.60000000044
Buy,95,4654.21,2021-11-13 22:15:00,442149.95,982.6500000004307
Sell,95,4658.2,2021-11-13 22:30:00,442529.0,443511.65000000043
Buy,95,4658.2,2021-11-13 22:30:00,442529.0,982.6500000004307
Sell,95,4639.39,2021-11-13 22:45:00,440742.05000000005,441724.7000000005
Buy,95,4639.39,2021-11-13 22:45:00,440742.05000000005,982.6500000004307
Sell,95,4650.12,2021-11-13 23:00:00,441761.39999999997,442744.0500000004
Buy,95,4650.12,2021-11-13 23:00:00,441761.39999999997,982.6500000004307
Sell,95,4642.72,2021-11-13 23:15:00,441058.4,442041.05000000045
Buy,95,4642.72,2021-11-13 23:15:00,441058.4,982.6500000004307
Sell,95,4641.35,2021-11-13 23:30:00,440928.25000000006,441910.9000000005
Buy,95,4641.35,2021-11-13 23:30:00,440928.25000000006,982.6500000004307
Sell,95,4644.42,2021-11-13 23:45:00,441219.9,442202.55000000045
Buy,95,4644.42,2021-11-13 23:45:00,441219.9,982.6500000004307
Sell,95,4652.4,2021-11-14 00:00:00,441977.99999999994,442960.6500000004
Buy,95,4652.4,2021-11-14 00:00:00,441977.99999999994,982.6500000004307
Sell,95,4690.41,2021-11-14 00:15:00,445588.95,446571.60000000044
Buy,95,4690.41,2021-11-14 00:15:00,445588.95,982.6500000004307
Sell,95,4682.59,2021-11-14 00:30:00,444846.05,445828.7000000004
Buy,95,4682.59,2021-11-14 00:30:00,444846.05,982.6500000004307
Sell,95,4676.22,2021-11-14 00:45:00,444240.9,445223.55000000045
Buy,95,4676.22,2021-11-14 00:45:00,444240.9,982.6500000004307
Sell,95,4670.69,2021-11-14 01:00:00,443715.55,444698.2000000004
Buy,95,4670.69,2021-11-14 01:00:00,443715.55,982.6500000004307
Sell,95,4665.77,2021-11-14 01:15:00,443248.15,444230.80000000045
Buy,95,4665.77,2021-11-14 01:15:00,443248.15,982.6500000004307
Sell,95,4652.5,2021-11-14 01:30:00,441987.5,442970.15000000043
Buy,95,4652.5,2021-11-14 01:30:00,441987.5,982.6500000004307
Sell,95,4662.02,2021-11-14 01:45:00,442891.9,443874.55000000045
Buy,95,4662.02,2021-11-14 01:45:00,442891.9,982.6500000004307
Sell,95,4663.71,2021-11-14 02:00:00,443052.45,444035.10000000044
Buy,95,4663.71,2021-11-14 02:00:00,443052.45,982.6500000004307
Sell,95,4658.02,2021-11-14 02:15:00,442511.9,443494.55000000045
Buy,95,4658.02,2021-11-14 02:15:00,442511.9,982.6500000004307
Sell,95,4642.92,2021-11-14 02:30:00,441077.4,442060.05000000045
Buy,95,4642.92,2021-11-14 02:30:00,441077.4,982.6500000004307
Sell,95,4635.95,2021-11-14 02:45:00,440415.25,441397.90000000043
Buy,95,4635.95,2021-11-14 02:45:00,440415.25,982.6500000004307
Sell,95,4627.0,2021-11-14 03:00:00,439565.0,440547.65000000043
Buy,95,4627.0,2021-11-14 03:00:00,439565.0,982.6500000004307
Sell,95,4632.28,2021-11-14 03:15:00,440066.6,441049.2500000004
Buy,95,4632.28,2021-11-14 03:15:00,440066.6,982.6500000004307
Sell,95,4631.27,2021-11-14 03:30:00,439970.65,440953.30000000045
Buy,95,4631.27,2021-11-14 03:30:00,439970.65,982.6500000004307
Sell,95,4628.63,2021-11-14 03:45:00,439719.85000000003,440702.50000000047
Buy,95,4628.63,2021-11-14 03:45:00,439719.85000000003,982.6500000004307
Sell,95,4634.54,2021-11-14 04:00:00,440281.3,441263.9500000004
Buy,95,4634.54,2021-11-14 04:00:00,440281.3,982.6500000004307
Sell,95,4640.91,2021-11-14 04:15:00,440886.45,441869.10000000044
Buy,95,4640.91,2021-11-14 04:15:00,440886.45,982.6500000004307
Sell,95,3805.72,2021-11-14 04:30:00,361543.39999999997,362526.0500000004
Buy,95,3805.72,2021-11-14 04:30:00,361543.39999999997,982.6500000004307
Sell,95,4633.83,2021-11-14 04:45:00,440213.85,441196.5000000004
Buy,95,4633.83,2021-11-14 04:45:00,440213.85,982.6500000004307
Sell,95,4644.19,2021-11-14 05:00:00,441198.05,442180.7000000004
Buy,95,4644.19,2021-11-14 05:00:00,441198.05,982.6500000004307
Sell,95,4633.51,2021-11-14 05:15:00,440183.45,441166.10000000044
Buy,95,4633.51,2021-11-14 05:15:00,440183.45,982.6500000004307
Sell,95,4639.75,2021-11-14 05:30:00,440776.25,441758.90000000043
Buy,95,4639.75,2021-11-14 05:30:00,440776.25,982.6500000004307
Sell,95,4642.78,2021-11-14 05:45:00,441064.1,442046.7500000004
Buy,95,4642.78,2021-11-14 05:45:00,441064.1,982.6500000004307
Sell,95,4647.99,2021-11-14 06:00:00,441559.05,442541.7000000004
Buy,95,4647.99,2021-11-14 06:00:00,441559.05,982.6500000004307
Sell,95,4646.48,2021-11-14 06:15:00,441415.6,442398.2500000004
Buy,95,4646.48,2021-11-14 06:15:00,441415.6,982.6500000004307
Sell,95,4635.27,2021-11-14 06:30:00,440350.65,441333.30000000045
Buy,95,4635.27,2021-11-14 06:30:00,440350.65,982.6500000004307
Sell,95,4640.58,2021-11-14 06:45:00,440855.1,441837.7500000004
Buy,95,4640.58,2021-11-14 06:45:00,440855.1,982.6500000004307
Sell,95,4633.92,2021-11-14 07:00:00,440222.4,441205.05000000045
Buy,95,4633.92,2021-11-14 07:00:00,440222.4,982.6500000004307
Sell,95,4629.95,2021-11-14 07:15:00,439845.25,440827.90000000043
Buy,95,4629.95,2021-11-14 07:15:00,439845.25,982.6500000004307
Sell,95,4603.7,2021-11-14 07:30:00,437351.5,438334.15000000043
Buy,95,4603.7,2021-11-14 07:30:00,437351.5,982.6500000004307
Sell,95,4599.27,2021-11-14 07:45:00,436930.65,437913.30000000045
Buy,95,4599.27,2021-11-14 07:45:00,436930.65,982.6500000004307
Sell,95,4596.29,2021-11-14 08:00:00,436647.55,437630.2000000004
Buy,95,4596.29,2021-11-14 08:00:00,436647.55,982.6500000004307
Sell,95,3805.72,2021-11-14 08:15:00,361543.39999999997,362526.0500000004
Buy,95,3805.72,2021-11-14 08:15:00,361543.39999999997,982.6500000004307
Sell,95,4592.27,2021-11-14 08:30:00,436265.65,437248.30000000045
Buy,95,4592.27,2021-11-14 08:30:00,436265.65,982.6500000004307
Sell,95,4584.61,2021-11-14 08:45:00,435537.94999999995,436520.6000000004
Buy,95,4584.61,2021-11-14 08:45:00,435537.94999999995,982.6500000004307
Sell,95,4582.53,2021-11-14 09:00:00,435340.35,436323.0000000004
Buy,95,4582.53,2021-11-14 09:00:00,435340.35,982.6500000004307
Sell,95,4604.77,2021-11-14 09:15:00,437453.15,438435.80000000045
Buy,95,4604.77,2021-11-14 09:15:00,437453.15,982.6500000004307
Sell,95,4599.29,2021-11-14 09:30:00,436932.55,437915.2000000004
Buy,95,4599.29,2021-11-14 09:30:00,436932.55,982.6500000004307
Sell,95,4591.07,2021-11-14 09:45:00,436151.64999999997,437134.3000000004
Buy,95,4591.07,2021-11-14 09:45:00,436151.64999999997,982.6500000004307
Sell,95,4598.92,2021-11-14 10:00:00,436897.4,437880.05000000045
Buy,95,4598.92,2021-11-14 10:00:00,436897.4,982.6500000004307
Sell,95,3805.72,2021-11-14 10:15:00,361543.39999999997,362526.0500000004
Buy,95,3805.72,2021-11-14 10:15:00,361543.39999999997,982.6500000004307
Sell,95,4610.1,2021-11-14 10:30:00,437959.50000000006,438942.1500000005
Buy,95,4610.1,2021-11-14 10:30:00,437959.50000000006,982.6500000004307
Sell,95,4607.54,2021-11-14 10:45:00,437716.3,438698.9500000004
Buy,95,4607.54,2021-11-14 10:45:00,437716.3,982.6500000004307
Sell,95,4605.62,2021-11-14 11:00:00,437533.89999999997,438516.5500000004
Buy,95,4605.62,2021-11-14 11:00:00,437533.89999999997,982.6500000004307
Sell,95,4613.28,2021-11-14 11:15:00,438261.6,439244.2500000004
Buy,95,4613.28,2021-11-14 11:15:00,438261.6,982.6500000004307
Sell,95,4610.58,2021-11-14 11:30:00,438005.1,438987.7500000004
Buy,95,4610.58,2021-11-14 11:30:00,438005.1,982.6500000004307
Sell,95,4613.31,2021-11-14 11:45:00,438264.45,439247.10000000044
Buy,95,4613.31,2021-11-14 11:45:00,438264.45,982.6500000004307
Sell,95,4601.02,2021-11-14 12:00:00,437096.9,438079.55000000045
Buy,95,4601.02,2021-11-14 12:00:00,437096.9,982.6500000004307
Sell,95,4607.39,2021-11-14 12:15:00,437702.05000000005,438684.7000000005
Buy,95,4607.39,2021-11-14 12:15:00,437702.05000000005,982.6500000004307
Sell,95,4627.01,2021-11-14 12:30:00,439565.95,440548.60000000044
Buy,95,4627.01,2021-11-14 12:30:00,439565.95,982.6500000004307
Sell,95,4620.71,2021-11-14 12:45:00,438967.45,439950.10000000044
Buy,95,4620.71,2021-11-14 12:45:00,438967.45,982.6500000004307
Sell,95,4616.9,2021-11-14 13:00:00,438605.49999999994,439588.1500000004
Buy,95,4616.9,2021-11-14 13:00:00,438605.49999999994,982.6500000004307
Sell,95,4624.89,2021-11-14 13:15:00,439364.55000000005,440347.2000000005
Buy,95,4624.89,2021-11-14 13:15:00,439364.55000000005,982.6500000004307
Sell,95,4617.68,2021-11-14 13:30:00,438679.60000000003,439662.25000000047
Buy,95,4617.68,2021-11-14 13:30:00,438679.60000000003,982.6500000004307
Sell,95,4614.39,2021-11-14 13:45:00,438367.05000000005,439349.7000000005
Buy,95,4614.39,2021-11-14 13:45:00,438367.05000000005,982.6500000004307
Sell,95,4600.78,2021-11-14 14:00:00,437074.1,438056.7500000004
Buy,95,4600.78,2021-11-14 14:00:00,437074.1,982.6500000004307
Sell,95,4590.8,2021-11-14 14:15:00,436126.0,437108.65000000043
Buy,95,4590.8,2021-11-14 14:15:00,436126.0,982.6500000004307
Sell,95,4585.68,2021-11-14 14:30:00,435639.60000000003,436622.25000000047
Buy,95,4585.68,2021-11-14 14:30:00,435639.60000000003,982.6500000004307
Sell,95,4594.38,2021-11-14 14:45:00,436466.10000000003,437448.75000000047
Buy,95,4594.38,2021-11-14 14:45:00,436466.10000000003,982.6500000004307
Sell,95,4577.58,2021-11-14 15:00:00,434870.1,435852.7500000004
Buy,95,4577.58,2021-11-14 15:00:00,434870.1,982.6500000004307
Sell,95,4589.01,2021-11-14 15:15:00,435955.95,436938.60000000044
Buy,95,4589.01,2021-11-14 15:15:00,435955.95,982.6500000004307
Sell,95,4590.1,2021-11-14 15:30:00,436059.50000000006,437042.1500000005
Buy,95,4590.1,2021-11-14 15:30:00,436059.50000000006,982.6500000004307
Sell,95,4584.91,2021-11-14 15:45:00,435566.45,436549.10000000044
Buy,95,4584.91,2021-11-14 15:45:00,435566.45,982.6500000004307
Sell,95,4565.49,2021-11-14 16:00:00,433721.55,434704.2000000004
Buy,95,4565.49,2021-11-14 16:00:00,433721.55,982.6500000004307
Sell,95,4571.52,2021-11-14 16:15:00,434294.4,435277.05000000045
Buy,95,4571.52,2021-11-14 16:15:00,434294.4,982.6500000004307
Sell,95,4539.43,2021-11-14 16:30:00,431245.85000000003,432228.50000000047
Buy,95,4539.43,2021-11-14 16:30:00,431245.85000000003,982.6500000004307
Sell,95,4540.01,2021-11-14 16:45:00,431300.95,432283.60000000044
Buy,95,4540.01,2021-11-14 16:45:00,431300.95,982.6500000004307
Sell,95,4533.22,2021-11-14 17:00:00,430655.9,431638.55000000045
Buy,95,4533.22,2021-11-14 17:00:00,430655.9,982.6500000004307
Sell,95,4535.23,2021-11-14 17:15:00,430846.85,431829.5000000004
Buy,95,4535.23,2021-11-14 17:15:00,430846.85,982.6500000004307
Sell,95,4528.67,2021-11-14 17:30:00,430223.65,431206.30000000045
Buy,95,4528.67,2021-11-14 17:30:00,430223.65,982.6500000004307
Sell,95,4560.38,2021-11-14 17:45:00,433236.10000000003,434218.75000000047
Buy,95,4560.38,2021-11-14 17:45:00,433236.10000000003,982.6500000004307
Sell,95,4555.3,2021-11-14 18:00:00,432753.5,433736.15000000043
Buy,95,4555.3,2021-11-14 18:00:00,432753.5,982.6500000004307
Sell,95,4543.83,2021-11-14 18:15:00,431663.85,432646.5000000004
Buy,95,4543.83,2021-11-14 18:15:00,431663.85,982.6500000004307
Sell,95,4548.44,2021-11-14 18:30:00,432101.8,433084.4500000004
Buy,95,4548.44,2021-11-14 18:30:00,432101.8,982.6500000004307
Sell,95,4551.33,2021-11-14 18:45:00,432376.35,433359.0000000004
Buy,95,4551.33,2021-11-14 18:45:00,432376.35,982.6500000004307
Sell,95,4526.36,2021-11-14 19:00:00,430004.19999999995,430986.8500000004
Buy,95,4526.36,2021-11-14 19:00:00,430004.19999999995,982.6500000004307
Sell,95,4540.01,2021-11-14 19:15:00,431300.95,432283.60000000044
Buy,95,4540.01,2021-11-14 19:15:00,431300.95,982.6500000004307
Sell,95,4536.86,2021-11-14 19:30:00,431001.69999999995,431984.3500000004
Buy,95,4536.86,2021-11-14 19:30:00,431001.69999999995,982.6500000004307
Sell,95,4549.03,2021-11-14 19:45:00,432157.85,433140.5000000004
Buy,95,4549.03,2021-11-14 19:45:00,432157.85,982.6500000004307
Sell,95,4553.0,2021-11-14 20:00:00,432535.0,433517.65000000043
Buy,95,4553.0,2021-11-14 20:00:00,432535.0,982.6500000004307
Sell,95,4551.06,2021-11-14 20:15:00,432350.7,433333.35000000044
Buy,95,4551.06,2021-11-14 20:15:00,432350.7,982.6500000004307
Sell,95,4544.66,2021-11-14 20:30:00,431742.7,432725.35000000044
Buy,95,4544.66,2021-11-14 20:30:00,431742.7,982.6500000004307
Sell,95,4556.03,2021-11-14 20:45:00,432822.85,433805.5000000004
Buy,95,4556.03,2021-11-14 20:45:00,432822.85,982.6500000004307
Sell,95,4567.39,2021-11-14 21:00:00,433902.05000000005,434884.7000000005
Buy,95,4567.39,2021-11-14 21:00:00,433902.05000000005,982.6500000004307
Sell,95,4557.05,2021-11-14 21:15:00,432919.75,433902.40000000043
Buy,95,4557.05,2021-11-14 21:15:00,432919.75,982.6500000004307
Sell,95,4593.63,2021-11-14 21:30:00,436394.85000000003,437377.50000000047
Buy,95,4593.63,2021-11-14 21:30:00,436394.85000000003,982.6500000004307
Sell,95,4577.96,2021-11-14 21:45:00,434906.2,435888.85000000044
Buy,95,4577.96,2021-11-14 21:45:00,434906.2,982.6500000004307
Sell,95,4585.87,2021-11-14 22:00:00,435657.64999999997,436640.3000000004
Buy,95,4585.87,2021-11-14 22:00:00,435657.64999999997,982.6500000004307
Sell,95,4591.35,2021-11-14 22:15:00,436178.25000000006,437160.9000000005
Buy,95,4591.35,2021-11-14 22:15:00,436178.25000000006,982.6500000004307
Sell,95,4586.61,2021-11-14 22:30:00,435727.94999999995,436710.6000000004
Buy,95,4586.61,2021-11-14 22:30:00,435727.94999999995,982.6500000004307
Sell,95,4576.66,2021-11-14 22:45:00,434782.7,435765.35000000044
Buy,95,4576.66,2021-11-14 22:45:00,434782.7,982.6500000004307
Sell,95,4590.9,2021-11-14 23:00:00,436135.49999999994,437118.1500000004
Buy,95,4590.9,2021-11-14 23:00:00,436135.49999999994,982.6500000004307
Sell,95,4604.0,2021-11-14 23:15:00,437380.0,438362.65000000043
Buy,95,4604.0,2021-11-14 23:15:00,437380.0,982.6500000004307
Sell,95,4610.49,2021-11-14 23:30:00,437996.55,438979.2000000004
Buy,95,4610.49,2021-11-14 23:30:00,437996.55,982.6500000004307
Sell,95,4629.44,2021-11-14 23:45:00,439796.8,440779.4500000004
Buy,95,4629.44,2021-11-14 23:45:00,439796.8,982.6500000004307
Sell,95,4656.3,2021-11-15 00:00:00,442348.5,443331.15000000043
Buy,95,4656.3,2021-11-15 00:00:00,442348.5,982.6500000004307
Sell,95,4679.99,2021-11-15 00:15:00,444599.05,445581.7000000004
Buy,95,4679.99,2021-11-15 00:15:00,444599.05,982.6500000004307
Sell,95,4681.84,2021-11-15 00:30:00,444774.8,445757.4500000004
Buy,95,4681.84,2021-11-15 00:30:00,444774.8,982.6500000004307
Sell,95,4680.01,2021-11-15 00:45:00,444600.95,445583.60000000044
Buy,95,4680.01,2021-11-15 00:45:00,444600.95,982.6500000004307
Sell,95,4692.85,2021-11-15 01:00:00,445820.75000000006,446803.4000000005
Buy,95,4692.85,2021-11-15 01:00:00,445820.75000000006,982.6500000004307
Sell,95,4676.96,2021-11-15 01:15:00,444311.2,445293.85000000044
Buy,95,4676.96,2021-11-15 01:15:00,444311.2,982.6500000004307
Sell,95,4694.08,2021-11-15 01:30:00,445937.6,446920.2500000004
Buy,95,4694.08,2021-11-15 01:30:00,445937.6,982.6500000004307
Sell,95,4719.25,2021-11-15 01:45:00,448328.75,449311.40000000043
Buy,95,4719.25,2021-11-15 01:45:00,448328.75,982.6500000004307
Sell,95,4710.57,2021-11-15 02:00:00,447504.14999999997,448486.8000000004
Buy,95,4710.57,2021-11-15 02:00:00,447504.14999999997,982.6500000004307
Sell,95,4706.09,2021-11-15 02:15:00,447078.55,448061.2000000004
Buy,95,4706.09,2021-11-15 02:15:00,447078.55,982.6500000004307
Sell,95,4710.6,2021-11-15 02:30:00,447507.00000000006,448489.6500000005
Buy,95,4710.6,2021-11-15 02:30:00,447507.00000000006,982.6500000004307
Sell,95,4698.5,2021-11-15 02:45:00,446357.5,447340.15000000043
Buy,95,4698.5,2021-11-15 02:45:00,446357.5,982.6500000004307
Sell,95,4704.0,2021-11-15 03:00:00,446880.0,447862.65000000043
Buy,95,4704.0,2021-11-15 03:00:00,446880.0,982.6500000004307
Sell,95,4695.68,2021-11-15 03:15:00,446089.60000000003,447072.25000000047
Buy,95,4695.68,2021-11-15 03:15:00,446089.60000000003,982.6500000004307
Sell,95,4711.0,2021-11-15 03:30:00,447545.0,448527.65000000043
Buy,95,4711.0,2021-11-15 03:30:00,447545.0,982.6500000004307
Sell,95,4706.5,2021-11-15 03:45:00,447117.5,448100.15000000043
Buy,95,4706.5,2021-11-15 03:45:00,447117.5,982.6500000004307
Sell,95,4718.91,2021-11-15 04:00:00,448296.45,449279.10000000044
Buy,95,4718.91,2021-11-15 04:00:00,448296.45,982.6500000004307
Sell,95,4718.63,2021-11-15 04:15:00,448269.85000000003,449252.50000000047
Buy,95,4718.63,2021-11-15 04:15:00,448269.85000000003,982.6500000004307
Sell,95,4708.76,2021-11-15 04:30:00,447332.2,448314.85000000044
Buy,95,4708.76,2021-11-15 04:30:00,447332.2,982.6500000004307
Sell,95,4707.84,2021-11-15 04:45:00,447244.8,448227.4500000004
Buy,95,4707.84,2021-11-15 04:45:00,447244.8,982.6500000004307
Sell,95,4712.37,2021-11-15 05:00:00,447675.14999999997,448657.8000000004
Buy,95,4712.37,2021-11-15 05:00:00,447675.14999999997,982.6500000004307
Sell,95,4705.88,2021-11-15 05:15:00,447058.60000000003,448041.25000000047
Buy,95,4705.88,2021-11-15 05:15:00,447058.60000000003,982.6500000004307
Sell,95,4701.63,2021-11-15 05:30:00,446654.85000000003,447637.50000000047
Buy,95,4701.63,2021-11-15 05:30:00,446654.85000000003,982.6500000004307
Sell,95,4696.02,2021-11-15 05:45:00,446121.9,447104.55000000045
Buy,95,4696.02,2021-11-15 05:45:00,446121.9,982.6500000004307
Sell,95,4703.6,2021-11-15 06:00:00,446842.00000000006,447824.6500000005
Buy,95,4703.6,2021-11-15 06:00:00,446842.00000000006,982.6500000004307
Sell,95,4707.99,2021-11-15 06:15:00,447259.05,448241.7000000004
Buy,95,4707.99,2021-11-15 06:15:00,447259.05,982.6500000004307
Sell,95,4706.53,2021-11-15 06:30:00,447120.35,448103.0000000004
Buy,95,4706.53,2021-11-15 06:30:00,447120.35,982.6500000004307
Sell,95,4699.98,2021-11-15 06:45:00,446498.1,447480.7500000004
Buy,95,4699.98,2021-11-15 06:45:00,446498.1,982.6500000004307
Sell,95,4699.58,2021-11-15 07:00:00,446460.1,447442.7500000004
Buy,95,4699.58,2021-11-15 07:00:00,446460.1,982.6500000004307
Sell,95,4685.0,2021-11-15 07:15:00,445075.0,446057.65000000043
Buy,95,4685.0,2021-11-15 07:15:00,445075.0,982.6500000004307
Sell,95,4680.95,2021-11-15 07:30:00,444690.25,445672.90000000043
Buy,95,4680.95,2021-11-15 07:30:00,444690.25,982.6500000004307
Sell,95,4683.28,2021-11-15 07:45:00,444911.6,445894.2500000004
Buy,95,4683.28,2021-11-15 07:45:00,444911.6,982.6500000004307
Sell,95,4673.09,2021-11-15 08:00:00,443943.55,444926.2000000004
Buy,95,4673.09,2021-11-15 08:00:00,443943.55,982.6500000004307
Sell,95,4678.03,2021-11-15 08:15:00,444412.85,445395.5000000004
Buy,95,4678.03,2021-11-15 08:15:00,444412.85,982.6500000004307
Sell,95,4718.03,2021-11-15 08:30:00,448212.85,449195.5000000004
Buy,95,4718.03,2021-11-15 08:30:00,448212.85,982.6500000004307
Sell,95,4722.22,2021-11-15 08:45:00,448610.9,449593.55000000045
Buy,95,4722.22,2021-11-15 08:45:00,448610.9,982.6500000004307
Sell,95,4748.28,2021-11-15 09:00:00,451086.6,452069.2500000004
Buy,95,4748.28,2021-11-15 09:00:00,451086.6,982.6500000004307
Sell,95,4733.54,2021-11-15 09:15:00,449686.3,450668.9500000004
Buy,95,4733.54,2021-11-15 09:15:00,449686.3,982.6500000004307
Sell,95,4717.49,2021-11-15 09:30:00,448161.55,449144.2000000004
Buy,95,4717.49,2021-11-15 09:30:00,448161.55,982.6500000004307
Sell,95,4725.65,2021-11-15 09:45:00,448936.74999999994,449919.4000000004
Buy,95,4725.65,2021-11-15 09:45:00,448936.74999999994,982.6500000004307
Sell,95,4722.88,2021-11-15 10:00:00,448673.60000000003,449656.25000000047
Buy,95,4722.88,2021-11-15 10:00:00,448673.60000000003,982.6500000004307
Sell,95,4715.26,2021-11-15 10:15:00,447949.7,448932.35000000044
Buy,95,4715.26,2021-11-15 10:15:00,447949.7,982.6500000004307
Sell,95,4735.88,2021-11-15 10:30:00,449908.60000000003,450891.25000000047
Buy,95,4735.88,2021-11-15 10:30:00,449908.60000000003,982.6500000004307
Sell,95,4733.28,2021-11-15 10:45:00,449661.6,450644.2500000004
Buy,95,4733.28,2021-11-15 10:45:00,449661.6,982.6500000004307
Sell,95,4730.35,2021-11-15 11:00:00,449383.25000000006,450365.9000000005
Buy,95,4730.35,2021-11-15 11:00:00,449383.25000000006,982.6500000004307
Sell,95,4721.75,2021-11-15 11:15:00,448566.25,449548.90000000043
Buy,95,4721.75,2021-11-15 11:15:00,448566.25,982.6500000004307
Sell,95,4727.8,2021-11-15 11:30:00,449141.0,450123.65000000043
Buy,95,4727.8,2021-11-15 11:30:00,449141.0,982.6500000004307
Sell,95,4726.78,2021-11-15 11:45:00,449044.1,450026.7500000004
Buy,95,4726.78,2021-11-15 11:45:00,449044.1,982.6500000004307
Sell,95,4723.58,2021-11-15 12:00:00,448740.1,449722.7500000004
Buy,95,4723.58,2021-11-15 12:00:00,448740.1,982.6500000004307
Sell,95,4723.57,2021-11-15 12:15:00,448739.14999999997,449721.8000000004
Buy,95,4723.57,2021-11-15 12:15:00,448739.14999999997,982.6500000004307
Sell,95,4735.56,2021-11-15 12:30:00,449878.2,450860.85000000044
Buy,95,4735.56,2021-11-15 12:30:00,449878.2,982.6500000004307
Sell,95,4741.87,2021-11-15 12:45:00,450477.64999999997,451460.3000000004
Buy,95,4741.87,2021-11-15 12:45:00,450477.64999999997,982.6500000004307
Sell,95,4768.78,2021-11-15 13:00:00,453034.1,454016.7500000004
Buy,95,4768.78,2021-11-15 13:00:00,453034.1,982.6500000004307
Sell,95,4745.93,2021-11-15 13:15:00,450863.35000000003,451846.00000000047
Buy,95,4745.93,2021-11-15 13:15:00,450863.35000000003,982.6500000004307
Sell,95,4723.73,2021-11-15 13:30:00,448754.35,449737.0000000004
Buy,95,4723.73,2021-11-15 13:30:00,448754.35,982.6500000004307
Sell,95,4725.57,2021-11-15 13:45:00,448929.14999999997,449911.8000000004
Buy,95,4725.57,2021-11-15 13:45:00,448929.14999999997,982.6500000004307
Sell,95,4698.33,2021-11-15 14:00:00,446341.35,447324.0000000004
Buy,95,4698.33,2021-11-15 14:00:00,446341.35,982.6500000004307
Sell,95,4694.31,2021-11-15 14:15:00,445959.45,446942.10000000044
Buy,95,4694.31,2021-11-15 14:15:00,445959.45,982.6500000004307
Sell,95,4698.52,2021-11-15 14:30:00,446359.4,447342.05000000045
Buy,95,4698.52,2021-11-15 14:30:00,446359.4,982.6500000004307
Sell,95,4685.99,2021-11-15 14:45:00,445169.05,446151.7000000004
Buy,95,4685.99,2021-11-15 14:45:00,445169.05,982.6500000004307
Sell,95,4656.31,2021-11-15 15:00:00,442349.45,443332.10000000044
Buy,95,4656.31,2021-11-15 15:00:00,442349.45,982.6500000004307
Sell,95,4656.76,2021-11-15 15:15:00,442392.2,443374.85000000044
Buy,95,4656.76,2021-11-15 15:15:00,442392.2,982.6500000004307
Sell,95,4645.11,2021-11-15 15:30:00,441285.44999999995,442268.1000000004
Buy,95,4645.11,2021-11-15 15:30:00,441285.44999999995,982.6500000004307
Sell,95,4651.35,2021-11-15 15:45:00,441878.25000000006,442860.9000000005
Buy,95,4651.35,2021-11-15 15:45:00,441878.25000000006,982.6500000004307
Sell,95,4637.24,2021-11-15 16:00:00,440537.8,441520.4500000004
Buy,95,4637.24,2021-11-15 16:00:00,440537.8,982.6500000004307
Sell,95,4618.22,2021-11-15 16:15:00,438730.9,439713.55000000045
Buy,95,4618.22,2021-11-15 16:15:00,438730.9,982.6500000004307
Sell,95,4611.36,2021-11-15 16:30:00,438079.19999999995,439061.8500000004
Buy,95,4611.36,2021-11-15 16:30:00,438079.19999999995,982.6500000004307
Sell,95,4620.06,2021-11-15 16:45:00,438905.7,439888.35000000044
Buy,95,4620.06,2021-11-15 16:45:00,438905.7,982.6500000004307
Sell,95,4623.27,2021-11-15 17:00:00,439210.65,440193.30000000045
Buy,95,4623.27,2021-11-15 17:00:00,439210.65,982.6500000004307
Sell,95,4613.11,2021-11-15 17:15:00,438245.44999999995,439228.1000000004
Buy,95,4613.11,2021-11-15 17:15:00,438245.44999999995,982.6500000004307
Sell,95,4626.02,2021-11-15 17:30:00,439471.9,440454.55000000045
Buy,95,4626.02,2021-11-15 17:30:00,439471.9,982.6500000004307
Sell,95,4610.55,2021-11-15 17:45:00,438002.25,438984.90000000043
Buy,95,4610.55,2021-11-15 17:45:00,438002.25,982.6500000004307
Sell,95,4591.78,2021-11-15 18:00:00,436219.1,437201.7500000004
Buy,95,4591.78,2021-11-15 18:00:00,436219.1,982.6500000004307
Sell,95,4602.0,2021-11-15 18:15:00,437190.0,438172.65000000043
Buy,95,4602.0,2021-11-15 18:15:00,437190.0,982.6500000004307
Sell,95,4584.48,2021-11-15 18:30:00,435525.6,436508.2500000004
Buy,95,4584.48,2021-11-15 18:30:00,435525.6,982.6500000004307
Sell,95,4589.74,2021-11-15 18:45:00,436025.3,437007.9500000004
Buy,95,4589.74,2021-11-15 18:45:00,436025.3,982.6500000004307
Sell,95,4588.64,2021-11-15 19:00:00,435920.80000000005,436903.4500000005
Buy,95,4588.64,2021-11-15 19:00:00,435920.80000000005,982.6500000004307
Sell,95,4591.67,2021-11-15 19:15:00,436208.65,437191.30000000045
Buy,95,4591.67,2021-11-15 19:15:00,436208.65,982.6500000004307
Sell,95,4606.43,2021-11-15 19:30:00,437610.85000000003,438593.50000000047
Buy,95,4606.43,2021-11-15 19:30:00,437610.85000000003,982.6500000004307
Sell,95,4603.98,2021-11-15 19:45:00,437378.1,438360.7500000004
Buy,95,4603.98,2021-11-15 19:45:00,437378.1,982.6500000004307
Sell,95,4579.01,2021-11-15 20:00:00,435005.95,435988.60000000044
Buy,95,4579.01,2021-11-15 20:00:00,435005.95,982.6500000004307
Sell,95,4562.96,2021-11-15 20:15:00,433481.2,434463.85000000044
Buy,95,4562.96,2021-11-15 20:15:00,433481.2,982.6500000004307
Sell,95,4563.79,2021-11-15 20:30:00,433560.05,434542.7000000004
Buy,95,4563.79,2021-11-15 20:30:00,433560.05,982.6500000004307
Sell,95,4566.12,2021-11-15 20:45:00,433781.39999999997,434764.0500000004
Buy,95,4566.12,2021-11-15 20:45:00,433781.39999999997,982.6500000004307
Sell,95,4574.89,2021-11-15 21:00:00,434614.55000000005,435597.2000000005
Buy,95,4574.89,2021-11-15 21:00:00,434614.55000000005,982.6500000004307
Sell,95,4568.15,2021-11-15 21:15:00,433974.24999999994,434956.9000000004
Buy,95,4568.15,2021-11-15 21:15:00,433974.24999999994,982.6500000004307
Sell,95,4578.43,2021-11-15 21:30:00,434950.85000000003,435933.50000000047
Buy,95,4578.43,2021-11-15 21:30:00,434950.85000000003,982.6500000004307
Sell,95,4572.33,2021-11-15 21:45:00,434371.35,435354.0000000004
Buy,95,4572.33,2021-11-15 21:45:00,434371.35,982.6500000004307
Sell,95,4551.05,2021-11-15 22:00:00,432349.75,433332.40000000043
Buy,95,4551.05,2021-11-15 22:00:00,432349.75,982.6500000004307
Sell,95,4557.03,2021-11-15 22:15:00,432917.85,433900.5000000004
Buy,95,4557.03,2021-11-15 22:15:00,432917.85,982.6500000004307
Sell,95,4565.82,2021-11-15 22:30:00,433752.89999999997,434735.5500000004
Buy,95,4565.82,2021-11-15 22:30:00,433752.89999999997,982.6500000004307
Sell,95,4584.43,2021-11-15 22:45:00,435520.85000000003,436503.50000000047
Buy,95,4584.43,2021-11-15 22:45:00,435520.85000000003,982.6500000004307
Sell,95,4574.29,2021-11-15 23:00:00,434557.55,435540.2000000004
Buy,95,4574.29,2021-11-15 23:00:00,434557.55,982.6500000004307
Sell,95,4564.52,2021-11-15 23:15:00,433629.4,434612.05000000045
Buy,95,4564.52,2021-11-15 23:15:00,433629.4,982.6500000004307
Sell,95,4576.55,2021-11-15 23:30:00,434772.25,435754.90000000043
Buy,95,4576.55,2021-11-15 23:30:00,434772.25,982.6500000004307
Sell,95,4567.01,2021-11-15 23:45:00,433865.95,434848.60000000044
Buy,95,4567.01,2021-11-15 23:45:00,433865.95,982.6500000004307
Sell,95,4501.52,2021-11-16 00:00:00,427644.4,428627.05000000045
Buy,95,4501.52,2021-11-16 00:00:00,427644.4,982.6500000004307
Sell,95,4474.76,2021-11-16 00:15:00,425102.2,426084.85000000044
Buy,95,4474.76,2021-11-16 00:15:00,425102.2,982.6500000004307
Sell,95,4484.23,2021-11-16 00:30:00,426001.85,426984.5000000004
Buy,95,4484.23,2021-11-16 00:30:00,426001.85,982.6500000004307
Sell,95,4440.97,2021-11-16 00:45:00,421892.15,422874.80000000045
Buy,95,4440.97,2021-11-16 00:45:00,421892.15,982.6500000004307
Sell,95,4386.55,2021-11-16 01:00:00,416722.25,417704.90000000043
Buy,95,4386.55,2021-11-16 01:00:00,416722.25,982.6500000004307
Sell,95,4371.87,2021-11-16 01:15:00,415327.64999999997,416310.3000000004
Buy,95,4371.87,2021-11-16 01:15:00,415327.64999999997,982.6500000004307
Sell,95,4391.74,2021-11-16 01:30:00,417215.3,418197.9500000004
Buy,95,4391.74,2021-11-16 01:30:00,417215.3,982.6500000004307
Sell,95,4399.15,2021-11-16 01:45:00,417919.24999999994,418901.9000000004
Buy,95,4399.15,2021-11-16 01:45:00,417919.24999999994,982.6500000004307
Sell,95,4399.56,2021-11-16 02:00:00,417958.2,418940.85000000044
Buy,95,4399.56,2021-11-16 02:00:00,417958.2,982.6500000004307
Sell,95,4387.01,2021-11-16 02:15:00,416765.95,417748.60000000044
Buy,95,4387.01,2021-11-16 02:15:00,416765.95,982.6500000004307
Sell,95,4374.06,2021-11-16 02:30:00,415535.7,416518.35000000044
Buy,95,4374.06,2021-11-16 02:30:00,415535.7,982.6500000004307
Sell,95,4348.93,2021-11-16 02:45:00,413148.35000000003,414131.00000000047
Buy,95,4348.93,2021-11-16 02:45:00,413148.35000000003,982.6500000004307
Sell,95,4367.9,2021-11-16 03:00:00,414950.49999999994,415933.1500000004
Buy,95,4367.9,2021-11-16 03:00:00,414950.49999999994,982.6500000004307
Sell,95,4307.42,2021-11-16 03:15:00,409204.9,410187.55000000045
Buy,95,4307.42,2021-11-16 03:15:00,409204.9,982.6500000004307
Sell,95,4297.96,2021-11-16 03:30:00,408306.2,409288.85000000044
Buy,95,4297.96,2021-11-16 03:30:00,408306.2,982.6500000004307
Sell,95,4311.89,2021-11-16 03:45:00,409629.55000000005,410612.2000000005
Buy,95,4311.89,2021-11-16 03:45:00,409629.55000000005,982.6500000004307
Sell,95,4272.61,2021-11-16 04:00:00,405897.94999999995,406880.6000000004
Buy,95,4272.61,2021-11-16 04:00:00,405897.94999999995,982.6500000004307
Sell,95,4321.62,2021-11-16 04:15:00,410553.89999999997,411536.5500000004
Buy,95,4321.62,2021-11-16 04:15:00,410553.89999999997,982.6500000004307
Sell,95,4347.47,2021-11-16 04:30:00,413009.65,413992.30000000045
Buy,95,4347.47,2021-11-16 04:30:00,413009.65,982.6500000004307
Sell,95,4344.44,2021-11-16 04:45:00,412721.8,413704.4500000004
Buy,95,4344.44,2021-11-16 04:45:00,412721.8,982.6500000004307
Sell,95,4335.42,2021-11-16 05:00:00,411864.9,412847.55000000045
Buy,95,4335.42,2021-11-16 05:00:00,411864.9,982.6500000004307
Sell,95,4354.25,2021-11-16 05:15:00,413653.75,414636.40000000043
Buy,95,4354.25,2021-11-16 05:15:00,413653.75,982.6500000004307
Sell,95,4358.6,2021-11-16 05:30:00,414067.00000000006,415049.6500000005
Buy,95,4358.6,2021-11-16 05:30:00,414067.00000000006,982.6500000004307
Sell,95,4337.97,2021-11-16 05:45:00,412107.15,413089.80000000045
Buy,95,4337.97,2021-11-16 05:45:00,412107.15,982.6500000004307
Sell,95,4338.09,2021-11-16 06:00:00,412118.55,413101.2000000004
Buy,95,4338.09,2021-11-16 06:00:00,412118.55,982.6500000004307
Sell,95,4292.96,2021-11-16 06:15:00,407831.2,408813.85000000044
Buy,95,4292.96,2021-11-16 06:15:00,407831.2,982.6500000004307
Sell,95,4318.32,2021-11-16 06:30:00,410240.39999999997,411223.0500000004
Buy,95,4318.32,2021-11-16 06:30:00,410240.39999999997,982.6500000004307
Sell,95,4338.37,2021-11-16 06:45:00,412145.14999999997,413127.8000000004
Buy,95,4338.37,2021-11-16 06:45:00,412145.14999999997,982.6500000004307
Sell,95,4321.97,2021-11-16 07:00:00,410587.15,411569.80000000045
Buy,95,4321.97,2021-11-16 07:00:00,410587.15,982.6500000004307
Sell,95,4316.54,2021-11-16 07:15:00,410071.3,411053.9500000004
Buy,95,4316.54,2021-11-16 07:15:00,410071.3,982.6500000004307
Sell,95,4297.86,2021-11-16 07:30:00,408296.69999999995,409279.3500000004
Buy,95,4297.86,2021-11-16 07:30:00,408296.69999999995,982.6500000004307
Sell,95,4313.06,2021-11-16 07:45:00,409740.7,410723.35000000044
Buy,95,4313.06,2021-11-16 07:45:00,409740.7,982.6500000004307
Sell,95,4308.89,2021-11-16 08:00:00,409344.55000000005,410327.2000000005
Buy,95,4308.89,2021-11-16 08:00:00,409344.55000000005,982.6500000004307
Sell,95,4298.73,2021-11-16 08:15:00,408379.35,409362.0000000004
Buy,95,4298.73,2021-11-16 08:15:00,408379.35,982.6500000004307
Sell,95,4318.08,2021-11-16 08:30:00,410217.6,411200.2500000004
Buy,95,4318.08,2021-11-16 08:30:00,410217.6,982.6500000004307
Sell,95,4326.83,2021-11-16 08:45:00,411048.85,412031.5000000004
Buy,95,4326.83,2021-11-16 08:45:00,411048.85,982.6500000004307
Sell,95,4306.51,2021-11-16 09:00:00,409118.45,410101.10000000044
Buy,95,4306.51,2021-11-16 09:00:00,409118.45,982.6500000004307
Sell,95,4295.34,2021-11-16 09:15:00,408057.3,409039.9500000004
Buy,95,4295.34,2021-11-16 09:15:00,408057.3,982.6500000004307
Sell,95,4274.45,2021-11-16 09:30:00,406072.75,407055.40000000043
Buy,95,4274.45,2021-11-16 09:30:00,406072.75,982.6500000004307
Sell,95,4238.27,2021-11-16 09:45:00,402635.65,403618.30000000045
Buy,95,4238.27,2021-11-16 09:45:00,402635.65,982.6500000004307
Sell,95,4104.29,2021-11-16 10:00:00,389907.55,390890.2000000004
Buy,95,4104.29,2021-11-16 10:00:00,389907.55,982.6500000004307
Sell,95,4179.8,2021-11-16 10:15:00,397081.0,398063.65000000043
Buy,95,4179.8,2021-11-16 10:15:00,397081.0,982.6500000004307
Sell,95,4239.97,2021-11-16 10:30:00,402797.15,403779.80000000045
Buy,95,4239.97,2021-11-16 10:30:00,402797.15,982.6500000004307
Sell,95,4251.74,2021-11-16 10:45:00,403915.3,404897.9500000004
Buy,95,4251.74,2021-11-16 10:45:00,403915.3,982.6500000004307
Sell,95,4255.19,2021-11-16 11:00:00,404243.05,405225.7000000004
Buy,95,4255.19,2021-11-16 11:00:00,404243.05,982.6500000004307
Sell,95,4264.05,2021-11-16 11:15:00,405084.75,406067.40000000043
Buy,95,4264.05,2021-11-16 11:15:00,405084.75,982.6500000004307
Sell,95,4263.26,2021-11-16 11:30:00,405009.7,405992.35000000044
Buy,95,4263.26,2021-11-16 11:30:00,405009.7,982.6500000004307
Sell,95,4291.27,2021-11-16 11:45:00,407670.65,408653.30000000045
Buy,95,4291.27,2021-11-16 11:45:00,407670.65,982.6500000004307
Sell,95,4289.87,2021-11-16 12:00:00,407537.64999999997,408520.3000000004
Buy,95,4289.87,2021-11-16 12:00:00,407537.64999999997,982.6500000004307
Sell,95,4273.99,2021-11-16 12:15:00,406029.05,407011.7000000004
Buy,95,4273.99,2021-11-16 12:15:00,406029.05,982.6500000004307
Sell,95,4257.46,2021-11-16 12:30:00,404458.7,405441.35000000044
Buy,95,4257.46,2021-11-16 12:30:00,404458.7,982.6500000004307
Sell,95,4227.66,2021-11-16 12:45:00,401627.7,402610.35000000044
Buy,95,4227.66,2021-11-16 12:45:00,401627.7,982.6500000004307
Sell,95,4232.9,2021-11-16 13:00:00,402125.49999999994,403108.1500000004
Buy,95,4232.9,2021-11-16 13:00:00,402125.49999999994,982.6500000004307
Sell,95,4254.92,2021-11-16 13:15:00,404217.4,405200.05000000045
Buy,95,4254.92,2021-11-16 13:15:00,404217.4,982.6500000004307
Sell,95,4282.35,2021-11-16 13:30:00,406823.25000000006,407805.9000000005
Buy,95,4282.35,2021-11-16 13:30:00,406823.25000000006,982.6500000004307
Sell,95,4276.76,2021-11-16 13:45:00,406292.2,407274.85000000044
Buy,95,4276.76,2021-11-16 13:45:00,406292.2,982.6500000004307
Sell,95,4303.47,2021-11-16 14:00:00,408829.65,409812.30000000045
Buy,95,4303.47,2021-11-16 14:00:00,408829.65,982.6500000004307
Sell,95,4315.08,2021-11-16 14:15:00,409932.6,410915.2500000004
Buy,95,4315.08,2021-11-16 14:15:00,409932.6,982.6500000004307
Sell,95,4340.92,2021-11-16 14:30:00,412387.4,413370.05000000045
Buy,95,4340.92,2021-11-16 14:30:00,412387.4,982.6500000004307
Sell,95,4311.41,2021-11-16 14:45:00,409583.95,410566.60000000044
Buy,95,4311.41,2021-11-16 14:45:00,409583.95,982.6500000004307
Sell,95,4310.17,2021-11-16 15:00:00,409466.15,410448.80000000045
Buy,95,4310.17,2021-11-16 15:00:00,409466.15,982.6500000004307
Sell,95,4300.85,2021-11-16 15:15:00,408580.75000000006,409563.4000000005
Buy,95,4300.85,2021-11-16 15:15:00,408580.75000000006,982.6500000004307
Sell,95,4287.6,2021-11-16 15:30:00,407322.00000000006,408304.6500000005
Buy,95,4287.6,2021-11-16 15:30:00,407322.00000000006,982.6500000004307
Sell,95,4284.14,2021-11-16 15:45:00,406993.30000000005,407975.9500000005
Buy,95,4284.14,2021-11-16 15:45:00,406993.30000000005,982.6500000004307
Sell,95,4313.77,2021-11-16 16:00:00,409808.15,410790.80000000045
Buy,95,4313.77,2021-11-16 16:00:00,409808.15,982.6500000004307
Sell,95,4301.06,2021-11-16 16:15:00,408600.7,409583.35000000044
Buy,95,4301.06,2021-11-16 16:15:00,408600.7,982.6500000004307
Sell,95,4305.33,2021-11-16 16:30:00,409006.35,409989.0000000004
Buy,95,4305.33,2021-11-16 16:30:00,409006.35,982.6500000004307
Sell,95,4317.1,2021-11-16 16:45:00,410124.50000000006,411107.1500000005
Buy,95,4317.1,2021-11-16 16:45:00,410124.50000000006,982.6500000004307
Sell,95,4324.05,2021-11-16 17:00:00,410784.75,411767.40000000043
Buy,95,4324.05,2021-11-16 17:00:00,410784.75,982.6500000004307
Sell,95,4313.05,2021-11-16 17:15:00,409739.75,410722.40000000043
Buy,95,4313.05,2021-11-16 17:15:00,409739.75,982.6500000004307
Sell,95,4301.84,2021-11-16 17:30:00,408674.8,409657.4500000004
Buy,95,4301.84,2021-11-16 17:30:00,408674.8,982.6500000004307
Sell,95,4293.47,2021-11-16 17:45:00,407879.65,408862.30000000045
Buy,95,4293.47,2021-11-16 17:45:00,407879.65,982.6500000004307
Sell,95,4309.98,2021-11-16 18:00:00,409448.1,410430.7500000004
Buy,95,4309.98,2021-11-16 18:00:00,409448.1,982.6500000004307
Sell,95,4286.5,2021-11-16 18:15:00,407217.5,408200.15000000043
Buy,95,4286.5,2021-11-16 18:15:00,407217.5,982.6500000004307
Sell,95,4253.8,2021-11-16 18:30:00,404111.0,405093.65000000043
Buy,95,4253.8,2021-11-16 18:30:00,404111.0,982.6500000004307
Sell,95,4236.43,2021-11-16 18:45:00,402460.85000000003,403443.50000000047
Buy,95,4236.43,2021-11-16 18:45:00,402460.85000000003,982.6500000004307
Sell,95,4263.26,2021-11-16 19:00:00,405009.7,405992.35000000044
Buy,95,4263.26,2021-11-16 19:00:00,405009.7,982.6500000004307
Sell,95,4276.65,2021-11-16 19:15:00,406281.74999999994,407264.4000000004
Buy,95,4276.65,2021-11-16 19:15:00,406281.74999999994,982.6500000004307
Sell,95,4259.57,2021-11-16 19:30:00,404659.14999999997,405641.8000000004
Buy,95,4259.57,2021-11-16 19:30:00,404659.14999999997,982.6500000004307
Sell,95,4265.7,2021-11-16 19:45:00,405241.5,406224.15000000043
Buy,95,4265.7,2021-11-16 19:45:00,405241.5,982.6500000004307
Sell,95,4242.23,2021-11-16 20:00:00,403011.85,403994.5000000004
Buy,95,4242.23,2021-11-16 20:00:00,403011.85,982.6500000004307
Sell,95,4206.28,2021-11-16 20:15:00,399596.6,400579.2500000004
Buy,95,4206.28,2021-11-16 20:15:00,399596.6,982.6500000004307
Sell,95,4174.85,2021-11-16 20:30:00,396610.75000000006,397593.4000000005
Buy,95,4174.85,2021-11-16 20:30:00,396610.75000000006,982.6500000004307
Sell,95,4196.59,2021-11-16 20:45:00,398676.05,399658.7000000004
Buy,95,4196.59,2021-11-16 20:45:00,398676.05,982.6500000004307
Sell,95,4251.69,2021-11-16 21:00:00,403910.55,404893.2000000004
Buy,95,4251.69,2021-11-16 21:00:00,403910.55,982.6500000004307
Sell,95,4245.0,2021-11-16 21:15:00,403275.0,404257.65000000043
Buy,95,4245.0,2021-11-16 21:15:00,403275.0,982.6500000004307
Sell,95,4256.94,2021-11-16 21:30:00,404409.3,405391.9500000004
Buy,95,4256.94,2021-11-16 21:30:00,404409.3,982.6500000004307
Sell,95,4254.61,2021-11-16 21:45:00,404187.94999999995,405170.6000000004
Buy,95,4254.61,2021-11-16 21:45:00,404187.94999999995,982.6500000004307
Sell,95,4281.18,2021-11-16 22:00:00,406712.10000000003,407694.75000000047
Buy,95,4281.18,2021-11-16 22:00:00,406712.10000000003,982.6500000004307
Sell,95,4282.33,2021-11-16 22:15:00,406821.35,407804.0000000004
Buy,95,4282.33,2021-11-16 22:15:00,406821.35,982.6500000004307
Sell,95,4278.52,2021-11-16 22:30:00,406459.4,407442.05000000045
Buy,95,4278.52,2021-11-16 22:30:00,406459.4,982.6500000004307
Sell,95,4260.78,2021-11-16 22:45:00,404774.1,405756.7500000004
Buy,95,4260.78,2021-11-16 22:45:00,404774.1,982.6500000004307
Sell,95,4247.22,2021-11-16 23:00:00,403485.9,404468.55000000045
Buy,95,4247.22,2021-11-16 23:00:00,403485.9,982.6500000004307
Sell,95,4243.97,2021-11-16 23:15:00,403177.15,404159.80000000045
Buy,95,4243.97,2021-11-16 23:15:00,403177.15,982.6500000004307
Sell,95,4237.43,2021-11-16 23:30:00,402555.85000000003,403538.50000000047
Buy,95,4237.43,2021-11-16 23:30:00,402555.85000000003,982.6500000004307
Sell,95,4209.42,2021-11-16 23:45:00,399894.9,400877.55000000045
Buy,95,4209.42,2021-11-16 23:45:00,399894.9,982.6500000004307
Sell,95,4217.32,2021-11-17 00:00:00,400645.39999999997,401628.0500000004
Buy,95,4217.32,2021-11-17 00:00:00,400645.39999999997,982.6500000004307
Sell,95,4199.99,2021-11-17 00:15:00,398999.05,399981.7000000004
Buy,95,4199.99,2021-11-17 00:15:00,398999.05,982.6500000004307
Sell,95,4182.88,2021-11-17 00:30:00,397373.60000000003,398356.25000000047
Buy,95,4182.88,2021-11-17 00:30:00,397373.60000000003,982.6500000004307
Sell,95,4185.16,2021-11-17 00:45:00,397590.2,398572.85000000044
Buy,95,4185.16,2021-11-17 00:45:00,397590.2,982.6500000004307
Sell,95,4187.07,2021-11-17 01:00:00,397771.64999999997,398754.3000000004
Buy,95,4187.07,2021-11-17 01:00:00,397771.64999999997,982.6500000004307
Sell,95,4219.01,2021-11-17 01:15:00,400805.95,401788.60000000044
Buy,95,4219.01,2021-11-17 01:15:00,400805.95,982.6500000004307
Sell,95,4216.08,2021-11-17 01:30:00,400527.6,401510.2500000004
Buy,95,4216.08,2021-11-17 01:30:00,400527.6,982.6500000004307
Sell,95,4134.04,2021-11-17 01:45:00,392733.8,393716.4500000004
Buy,95,4134.04,2021-11-17 01:45:00,392733.8,982.6500000004307
Sell,95,4134.01,2021-11-17 02:00:00,392730.95,393713.60000000044
Buy,95,4134.01,2021-11-17 02:00:00,392730.95,982.6500000004307
Sell,95,4155.4,2021-11-17 02:15:00,394762.99999999994,395745.6500000004
Buy,95,4155.4,2021-11-17 02:15:00,394762.99999999994,982.6500000004307
Sell,95,4142.78,2021-11-17 02:30:00,393564.1,394546.7500000004
Buy,95,4142.78,2021-11-17 02:30:00,393564.1,982.6500000004307
Sell,95,4137.32,2021-11-17 02:45:00,393045.39999999997,394028.0500000004
Buy,95,4137.32,2021-11-17 02:45:00,393045.39999999997,982.6500000004307
Sell,95,4092.48,2021-11-17 03:00:00,388785.6,389768.2500000004
Buy,95,4092.48,2021-11-17 03:00:00,388785.6,982.6500000004307
Sell,95,4153.73,2021-11-17 03:15:00,394604.35,395587.0000000004
Buy,95,4153.73,2021-11-17 03:15:00,394604.35,982.6500000004307
Sell,95,4155.54,2021-11-17 03:30:00,394776.3,395758.9500000004
Buy,95,4155.54,2021-11-17 03:30:00,394776.3,982.6500000004307
Sell,95,4123.81,2021-11-17 03:45:00,391761.95,392744.60000000044
Buy,95,4123.81,2021-11-17 03:45:00,391761.95,982.6500000004307
Sell,95,4090.53,2021-11-17 04:00:00,388600.35000000003,389583.00000000047
Buy,95,4090.53,2021-11-17 04:00:00,388600.35000000003,982.6500000004307
Sell,95,4134.8,2021-11-17 04:15:00,392806.0,393788.65000000043
Buy,95,4134.8,2021-11-17 04:15:00,392806.0,982.6500000004307
Sell,95,4121.65,2021-11-17 04:30:00,391556.74999999994,392539.4000000004
Buy,95,4121.65,2021-11-17 04:30:00,391556.74999999994,982.6500000004307
Sell,95,4143.32,2021-11-17 04:45:00,393615.39999999997,394598.0500000004
Buy,95,4143.32,2021-11-17 04:45:00,393615.39999999997,982.6500000004307
Sell,95,4145.95,2021-11-17 05:00:00,393865.25,394847.90000000043
Buy,95,4145.95,2021-11-17 05:00:00,393865.25,982.6500000004307
Sell,95,4144.55,2021-11-17 05:15:00,393732.25,394714.90000000043
Buy,95,4144.55,2021-11-17 05:15:00,393732.25,982.6500000004307
Sell,95,4170.07,2021-11-17 05:30:00,396156.64999999997,397139.3000000004
Buy,95,4170.07,2021-11-17 05:30:00,396156.64999999997,982.6500000004307
Sell,95,4175.01,2021-11-17 05:45:00,396625.95,397608.60000000044
Buy,95,4175.01,2021-11-17 05:45:00,396625.95,982.6500000004307
Sell,95,4156.31,2021-11-17 06:00:00,394849.45,395832.10000000044
Buy,95,4156.31,2021-11-17 06:00:00,394849.45,982.6500000004307
Sell,95,4168.54,2021-11-17 06:15:00,396011.3,396993.9500000004
Buy,95,4168.54,2021-11-17 06:15:00,396011.3,982.6500000004307
Sell,95,4174.71,2021-11-17 06:30:00,396597.45,397580.10000000044
Buy,95,4174.71,2021-11-17 06:30:00,396597.45,982.6500000004307
Sell,95,4166.54,2021-11-17 06:45:00,395821.3,396803.9500000004
Buy,95,4166.54,2021-11-17 06:45:00,395821.3,982.6500000004307
Sell,95,4155.57,2021-11-17 07:00:00,394779.14999999997,395761.8000000004
Buy,95,4155.57,2021-11-17 07:00:00,394779.14999999997,982.6500000004307
Sell,95,4158.54,2021-11-17 07:15:00,395061.3,396043.9500000004
Buy,95,4158.54,2021-11-17 07:15:00,395061.3,982.6500000004307
Sell,95,4196.92,2021-11-17 07:30:00,398707.4,399690.05000000045
Buy,95,4196.92,2021-11-17 07:30:00,398707.4,982.6500000004307
Sell,95,4182.88,2021-11-17 07:45:00,397373.60000000003,398356.25000000047
Buy,95,4182.88,2021-11-17 07:45:00,397373.60000000003,982.6500000004307
Sell,95,4202.99,2021-11-17 08:00:00,399284.05,400266.7000000004
Buy,95,4202.99,2021-11-17 08:00:00,399284.05,982.6500000004307
Sell,95,4195.76,2021-11-17 08:15:00,398597.2,399579.85000000044
Buy,95,4195.76,2021-11-17 08:15:00,398597.2,982.6500000004307
Sell,95,4205.73,2021-11-17 08:30:00,399544.35,400527.0000000004
Buy,95,4205.73,2021-11-17 08:30:00,399544.35,982.6500000004307
Sell,95,4193.98,2021-11-17 08:45:00,398428.1,399410.7500000004
Buy,95,4193.98,2021-11-17 08:45:00,398428.1,982.6500000004307
Sell,95,4166.43,2021-11-17 09:00:00,395810.85000000003,396793.50000000047
Buy,95,4166.43,2021-11-17 09:00:00,395810.85000000003,982.6500000004307
Sell,95,4145.8,2021-11-17 09:15:00,393851.0,394833.65000000043
Buy,95,4145.8,2021-11-17 09:15:00,393851.0,982.6500000004307
Sell,95,4151.08,2021-11-17 09:30:00,394352.6,395335.2500000004
Buy,95,4151.08,2021-11-17 09:30:00,394352.6,982.6500000004307
Sell,95,4129.52,2021-11-17 09:45:00,392304.4,393287.05000000045
Buy,95,4129.52,2021-11-17 09:45:00,392304.4,982.6500000004307
Sell,95,4143.32,2021-11-17 10:00:00,393615.39999999997,394598.0500000004
Buy,95,4143.32,2021-11-17 10:00:00,393615.39999999997,982.6500000004307
Sell,95,4140.31,2021-11-17 10:15:00,393329.45,394312.10000000044
Buy,95,4140.31,2021-11-17 10:15:00,393329.45,982.6500000004307
Sell,95,4183.09,2021-11-17 10:30:00,397393.55,398376.2000000004
Buy,95,4183.09,2021-11-17 10:30:00,397393.55,982.6500000004307
Sell,95,4227.36,2021-11-17 10:45:00,401599.19999999995,402581.8500000004
Buy,95,4227.36,2021-11-17 10:45:00,401599.19999999995,982.6500000004307
Sell,95,4216.01,2021-11-17 11:00:00,400520.95,401503.60000000044
Buy,95,4216.01,2021-11-17 11:00:00,400520.95,982.6500000004307
Sell,95,4221.75,2021-11-17 11:15:00,401066.25,402048.90000000043
Buy,95,4221.75,2021-11-17 11:15:00,401066.25,982.6500000004307
Sell,95,4224.23,2021-11-17 11:30:00,401301.85,402284.5000000004
Buy,95,4224.23,2021-11-17 11:30:00,401301.85,982.6500000004307
Sell,95,4251.78,2021-11-17 11:45:00,403919.1,404901.7500000004
Buy,95,4251.78,2021-11-17 11:45:00,403919.1,982.6500000004307
Sell,95,4248.0,2021-11-17 12:00:00,403560.0,404542.65000000043
Buy,95,4248.0,2021-11-17 12:00:00,403560.0,982.6500000004307
Sell,95,4234.34,2021-11-17 12:15:00,402262.3,403244.9500000004
Buy,95,4234.34,2021-11-17 12:15:00,402262.3,982.6500000004307
Sell,95,4244.5,2021-11-17 12:30:00,403227.5,404210.15000000043
Buy,95,4244.5,2021-11-17 12:30:00,403227.5,982.6500000004307
Sell,95,4244.69,2021-11-17 12:45:00,403245.55,404228.2000000004
Buy,95,4244.69,2021-11-17 12:45:00,403245.55,982.6500000004307
Sell,95,4235.05,2021-11-17 13:00:00,402329.75,403312.40000000043
Buy,95,4235.05,2021-11-17 13:00:00,402329.75,982.6500000004307
Sell,95,4230.47,2021-11-17 13:15:00,401894.65,402877.30000000045
Buy,95,4230.47,2021-11-17 13:15:00,401894.65,982.6500000004307
Sell,95,4228.21,2021-11-17 13:30:00,401679.95,402662.60000000044
Buy,95,4228.21,2021-11-17 13:30:00,401679.95,982.6500000004307
Sell,95,4223.65,2021-11-17 13:45:00,401246.74999999994,402229.4000000004
Buy,95,4223.65,2021-11-17 13:45:00,401246.74999999994,982.6500000004307
Sell,95,4226.0,2021-11-17 14:00:00,401470.0,402452.65000000043
Buy,95,4226.0,2021-11-17 14:00:00,401470.0,982.6500000004307
Sell,95,4231.82,2021-11-17 14:15:00,402022.89999999997,403005.5500000004
Buy,95,4231.82,2021-11-17 14:15:00,402022.89999999997,982.6500000004307
Sell,95,4194.24,2021-11-17 14:30:00,398452.8,399435.4500000004
Buy,95,4194.24,2021-11-17 14:30:00,398452.8,982.6500000004307
Sell,95,4172.5,2021-11-17 14:45:00,396387.5,397370.15000000043
Buy,95,4172.5,2021-11-17 14:45:00,396387.5,982.6500000004307
Sell,95,4170.61,2021-11-17 15:00:00,396207.94999999995,397190.6000000004
Buy,95,4170.61,2021-11-17 15:00:00,396207.94999999995,982.6500000004307
Sell,95,4152.42,2021-11-17 15:15:00,394479.9,395462.55000000045
Buy,95,4152.42,2021-11-17 15:15:00,394479.9,982.6500000004307
Sell,95,4175.93,2021-11-17 15:30:00,396713.35000000003,397696.00000000047
Buy,95,4175.93,2021-11-17 15:30:00,396713.35000000003,982.6500000004307
Sell,95,4176.0,2021-11-17 15:45:00,396720.0,397702.65000000043
Buy,95,4176.0,2021-11-17 15:45:00,396720.0,982.6500000004307
Sell,95,4191.39,2021-11-17 16:00:00,398182.05000000005,399164.7000000005
Buy,95,4191.39,2021-11-17 16:00:00,398182.05000000005,982.6500000004307
Sell,95,4196.36,2021-11-17 16:15:00,398654.19999999995,399636.8500000004
Buy,95,4196.36,2021-11-17 16:15:00,398654.19999999995,982.6500000004307
Sell,95,4227.6,2021-11-17 16:30:00,401622.00000000006,402604.6500000005
Buy,95,4227.6,2021-11-17 16:30:00,401622.00000000006,982.6500000004307
Sell,95,4235.62,2021-11-17 16:45:00,402383.89999999997,403366.5500000004
Buy,95,4235.62,2021-11-17 16:45:00,402383.89999999997,982.6500000004307
Sell,95,4210.0,2021-11-17 17:00:00,399950.0,400932.65000000043
Buy,95,4210.0,2021-11-17 17:00:00,399950.0,982.6500000004307
Sell,95,4202.48,2021-11-17 17:15:00,399235.6,400218.2500000004
Buy,95,4202.48,2021-11-17 17:15:00,399235.6,982.6500000004307
Sell,95,4217.74,2021-11-17 17:30:00,400685.3,401667.9500000004
Buy,95,4217.74,2021-11-17 17:30:00,400685.3,982.6500000004307
Sell,95,4232.97,2021-11-17 17:45:00,402132.15,403114.80000000045
Buy,95,4232.97,2021-11-17 17:45:00,402132.15,982.6500000004307
Sell,95,4238.72,2021-11-17 18:00:00,402678.4,403661.05000000045
Buy,95,4238.72,2021-11-17 18:00:00,402678.4,982.6500000004307
Sell,95,4247.87,2021-11-17 18:15:00,403547.64999999997,404530.3000000004
Buy,95,4247.87,2021-11-17 18:15:00,403547.64999999997,982.6500000004307
Sell,95,4241.72,2021-11-17 18:30:00,402963.4,403946.05000000045
Buy,95,4241.72,2021-11-17 18:30:00,402963.4,982.6500000004307
Sell,95,4249.5,2021-11-17 18:45:00,403702.5,404685.15000000043
Buy,95,4249.5,2021-11-17 18:45:00,403702.5,982.6500000004307
Sell,95,4245.59,2021-11-17 19:00:00,403331.05,404313.7000000004
Buy,95,4245.59,2021-11-17 19:00:00,403331.05,982.6500000004307
Sell,95,4249.55,2021-11-17 19:15:00,403707.25,404689.90000000043
Buy,95,4249.55,2021-11-17 19:15:00,403707.25,982.6500000004307
Sell,95,4237.81,2021-11-17 19:30:00,402591.95,403574.60000000044
Buy,95,4237.81,2021-11-17 19:30:00,402591.95,982.6500000004307
Sell,95,4241.67,2021-11-17 19:45:00,402958.65,403941.30000000045
Buy,95,4241.67,2021-11-17 19:45:00,402958.65,982.6500000004307
Sell,95,4228.42,2021-11-17 20:00:00,401699.9,402682.55000000045
Buy,95,4228.42,2021-11-17 20:00:00,401699.9,982.6500000004307
Sell,95,4225.91,2021-11-17 20:15:00,401461.45,402444.10000000044
Buy,95,4225.91,2021-11-17 20:15:00,401461.45,982.6500000004307
Sell,95,4262.08,2021-11-17 20:30:00,404897.6,405880.2500000004
Buy,95,4262.08,2021-11-17 20:30:00,404897.6,982.6500000004307
Sell,95,4256.2,2021-11-17 20:45:00,404339.0,405321.65000000043
Buy,95,4256.2,2021-11-17 20:45:00,404339.0,982.6500000004307
Sell,95,4240.45,2021-11-17 21:00:00,402842.75,403825.40000000043
Buy,95,4240.45,2021-11-17 21:00:00,402842.75,982.6500000004307
Sell,95,4216.47,2021-11-17 21:15:00,400564.65,401547.30000000045
Buy,95,4216.47,2021-11-17 21:15:00,400564.65,982.6500000004307
Sell,95,4230.68,2021-11-17 21:30:00,401914.60000000003,402897.25000000047
Buy,95,4230.68,2021-11-17 21:30:00,401914.60000000003,982.6500000004307
Sell,95,4254.36,2021-11-17 21:45:00,404164.19999999995,405146.8500000004
Buy,95,4254.36,2021-11-17 21:45:00,404164.19999999995,982.6500000004307
Sell,95,4260.92,2021-11-17 22:00:00,404787.4,405770.05000000045
Buy,95,4260.92,2021-11-17 22:00:00,404787.4,982.6500000004307
Sell,95,4224.29,2021-11-17 22:15:00,401307.55,402290.2000000004
Buy,95,4224.29,2021-11-17 22:15:00,401307.55,982.6500000004307
Sell,95,4235.0,2021-11-17 22:30:00,402325.0,403307.65000000043
Buy,95,4235.0,2021-11-17 22:30:00,402325.0,982.6500000004307
Sell,95,4236.1,2021-11-17 22:45:00,402429.50000000006,403412.1500000005
Buy,95,4236.1,2021-11-17 22:45:00,402429.50000000006,982.6500000004307
Sell,95,4223.47,2021-11-17 23:00:00,401229.65,402212.30000000045
Buy,95,4223.47,2021-11-17 23:00:00,401229.65,982.6500000004307
Sell,95,4245.24,2021-11-17 23:15:00,403297.8,404280.4500000004
Buy,95,4245.24,2021-11-17 23:15:00,403297.8,982.6500000004307
Sell,95,4261.09,2021-11-17 23:30:00,404803.55,405786.2000000004
Buy,95,4261.09,2021-11-17 23:30:00,404803.55,982.6500000004307
Sell,95,4287.99,2021-11-17 23:45:00,407359.05,408341.7000000004
Buy,95,4287.99,2021-11-17 23:45:00,407359.05,982.6500000004307
Sell,95,4297.74,2021-11-18 00:00:00,408285.3,409267.9500000004
Buy,95,4297.74,2021-11-18 00:00:00,408285.3,982.6500000004307
Sell,95,4308.07,2021-11-18 00:15:00,409266.64999999997,410249.3000000004
Buy,95,4308.07,2021-11-18 00:15:00,409266.64999999997,982.6500000004307
Sell,95,4311.85,2021-11-18 00:30:00,409625.75000000006,410608.4000000005
Buy,95,4311.85,2021-11-18 00:30:00,409625.75000000006,982.6500000004307
Sell,95,4320.95,2021-11-18 00:45:00,410490.25,411472.90000000043
Buy,95,4320.95,2021-11-18 00:45:00,410490.25,982.6500000004307
Sell,95,4299.43,2021-11-18 01:00:00,408445.85000000003,409428.50000000047
Buy,95,4299.43,2021-11-18 01:00:00,408445.85000000003,982.6500000004307
Sell,95,4300.5,2021-11-18 01:15:00,408547.5,409530.15000000043
Buy,95,4300.5,2021-11-18 01:15:00,408547.5,982.6500000004307
Sell,95,4324.87,2021-11-18 01:30:00,410862.64999999997,411845.3000000004
Buy,95,4324.87,2021-11-18 01:30:00,410862.64999999997,982.6500000004307
Sell,95,4309.47,2021-11-18 01:45:00,409399.65,410382.30000000045
Buy,95,4309.47,2021-11-18 01:45:00,409399.65,982.6500000004307
Sell,95,4305.0,2021-11-18 02:00:00,408975.0,409957.65000000043
Buy,95,4305.0,2021-11-18 02:00:00,408975.0,982.6500000004307
Sell,95,4313.62,2021-11-18 02:15:00,409793.89999999997,410776.5500000004
Buy,95,4313.62,2021-11-18 02:15:00,409793.89999999997,982.6500000004307
Sell,95,4323.83,2021-11-18 02:30:00,410763.85,411746.5000000004
Buy,95,4323.83,2021-11-18 02:30:00,410763.85,982.6500000004307
Sell,95,4335.7,2021-11-18 02:45:00,411891.5,412874.15000000043
Buy,95,4335.7,2021-11-18 02:45:00,411891.5,982.6500000004307
Sell,95,4311.28,2021-11-18 03:00:00,409571.6,410554.2500000004
Buy,95,4311.28,2021-11-18 03:00:00,409571.6,982.6500000004307
Sell,95,4307.85,2021-11-18 03:15:00,409245.75000000006,410228.4000000005
Buy,95,4307.85,2021-11-18 03:15:00,409245.75000000006,982.6500000004307
Sell,95,4299.29,2021-11-18 03:30:00,408432.55,409415.2000000004
Buy,95,4299.29,2021-11-18 03:30:00,408432.55,982.6500000004307
Sell,95,4279.29,2021-11-18 03:45:00,406532.55,407515.2000000004
Buy,95,4279.29,2021-11-18 03:45:00,406532.55,982.6500000004307
Sell,95,4278.84,2021-11-18 04:00:00,406489.8,407472.4500000004
Buy,95,4278.84,2021-11-18 04:00:00,406489.8,982.6500000004307
Sell,95,4265.95,2021-11-18 04:15:00,405265.25,406247.90000000043
Buy,95,4265.95,2021-11-18 04:15:00,405265.25,982.6500000004307
Sell,95,4261.14,2021-11-18 04:30:00,404808.30000000005,405790.9500000005
Buy,95,4261.14,2021-11-18 04:30:00,404808.30000000005,982.6500000004307
Sell,95,4254.65,2021-11-18 04:45:00,404191.74999999994,405174.4000000004
Buy,95,4254.65,2021-11-18 04:45:00,404191.74999999994,982.6500000004307
Sell,95,4249.01,2021-11-18 05:00:00,403655.95,404638.60000000044
Buy,95,4249.01,2021-11-18 05:00:00,403655.95,982.6500000004307
Sell,95,4252.09,2021-11-18 05:15:00,403948.55,404931.2000000004
Buy,95,4252.09,2021-11-18 05:15:00,403948.55,982.6500000004307
Sell,95,4257.54,2021-11-18 05:30:00,404466.3,405448.9500000004
Buy,95,4257.54,2021-11-18 05:30:00,404466.3,982.6500000004307
Sell,95,4254.96,2021-11-18 05:45:00,404221.2,405203.85000000044
Buy,95,4254.96,2021-11-18 05:45:00,404221.2,982.6500000004307
Sell,95,4247.02,2021-11-18 06:00:00,403466.9,404449.55000000045
Buy,95,4247.02,2021-11-18 06:00:00,403466.9,982.6500000004307
Sell,95,4256.16,2021-11-18 06:15:00,404335.2,405317.85000000044
Buy,95,4256.16,2021-11-18 06:15:00,404335.2,982.6500000004307
Sell,95,4252.93,2021-11-18 06:30:00,404028.35000000003,405011.00000000047
Buy,95,4252.93,2021-11-18 06:30:00,404028.35000000003,982.6500000004307
Sell,95,4248.76,2021-11-18 06:45:00,403632.2,404614.85000000044
Buy,95,4248.76,2021-11-18 06:45:00,403632.2,982.6500000004307
Sell,95,4233.39,2021-11-18 07:00:00,402172.05000000005,403154.7000000005
Buy,95,4233.39,2021-11-18 07:00:00,402172.05000000005,982.6500000004307
Sell,95,4233.91,2021-11-18 07:15:00,402221.45,403204.10000000044
Buy,95,4233.91,2021-11-18 07:15:00,402221.45,982.6500000004307
Sell,95,4241.41,2021-11-18 07:30:00,402933.95,403916.60000000044
Buy,95,4241.41,2021-11-18 07:30:00,402933.95,982.6500000004307
Sell,95,4247.83,2021-11-18 07:45:00,403543.85,404526.5000000004
Buy,95,4247.83,2021-11-18 07:45:00,403543.85,982.6500000004307
Sell,95,4235.03,2021-11-18 08:00:00,402327.85,403310.5000000004
Buy,95,4235.03,2021-11-18 08:00:00,402327.85,982.6500000004307
Sell,95,4256.82,2021-11-18 08:15:00,404397.89999999997,405380.5500000004
Buy,95,4256.82,2021-11-18 08:15:00,404397.89999999997,982.6500000004307
Sell,95,4237.3,2021-11-18 08:30:00,402543.5,403526.15000000043
Buy,95,4237.3,2021-11-18 08:30:00,402543.5,982.6500000004307
Sell,95,4242.46,2021-11-18 08:45:00,403033.7,404016.35000000044
Buy,95,4242.46,2021-11-18 08:45:00,403033.7,982.6500000004307
Sell,95,4213.67,2021-11-18 09:00:00,400298.65,401281.30000000045
Buy,95,4213.67,2021-11-18 09:00:00,400298.65,982.6500000004307
Sell,95,4202.56,2021-11-18 09:15:00,399243.2,400225.85000000044
Buy,95,4202.56,2021-11-18 09:15:00,399243.2,982.6500000004307
Sell,95,4196.31,2021-11-18 09:30:00,398649.45,399632.10000000044
Buy,95,4196.31,2021-11-18 09:30:00,398649.45,982.6500000004307
Sell,95,4206.08,2021-11-18 09:45:00,399577.6,400560.2500000004
Buy,95,4206.08,2021-11-18 09:45:00,399577.6,982.6500000004307
Sell,95,4191.33,2021-11-18 10:00:00,398176.35,399159.0000000004
Buy,95,4191.33,2021-11-18 10:00:00,398176.35,982.6500000004307
Sell,95,4207.08,2021-11-18 10:15:00,399672.6,400655.2500000004
Buy,95,4207.08,2021-11-18 10:15:00,399672.6,982.6500000004307
Sell,95,4222.84,2021-11-18 10:30:00,401169.8,402152.4500000004
Buy,95,4222.84,2021-11-18 10:30:00,401169.8,982.6500000004307
Sell,95,4240.59,2021-11-18 10:45:00,402856.05,403838.7000000004
Buy,95,4240.59,2021-11-18 10:45:00,402856.05,982.6500000004307
Sell,95,4235.74,2021-11-18 11:00:00,402395.3,403377.9500000004
Buy,95,4235.74,2021-11-18 11:00:00,402395.3,982.6500000004307
Sell,95,4233.68,2021-11-18 11:15:00,402199.60000000003,403182.25000000047
Buy,95,4233.68,2021-11-18 11:15:00,402199.60000000003,982.6500000004307
Sell,95,4214.75,2021-11-18 11:30:00,400401.25,401383.90000000043
Buy,95,4214.75,2021-11-18 11:30:00,400401.25,982.6500000004307
Sell,95,4190.0,2021-11-18 11:45:00,398050.0,399032.65000000043
Buy,95,4190.0,2021-11-18 11:45:00,398050.0,982.6500000004307
Sell,95,4211.0,2021-11-18 12:00:00,400045.0,401027.65000000043
Buy,95,4211.0,2021-11-18 12:00:00,400045.0,982.6500000004307
Sell,95,4209.96,2021-11-18 12:15:00,399946.2,400928.85000000044
Buy,95,4209.96,2021-11-18 12:15:00,399946.2,982.6500000004307
Sell,95,4195.66,2021-11-18 12:30:00,398587.7,399570.35000000044
Buy,95,4195.66,2021-11-18 12:30:00,398587.7,982.6500000004307
Sell,95,4183.04,2021-11-18 12:45:00,397388.8,398371.4500000004
Buy,95,4183.04,2021-11-18 12:45:00,397388.8,982.6500000004307
Sell,95,4171.72,2021-11-18 13:00:00,396313.4,397296.05000000045
Buy,95,4171.72,2021-11-18 13:00:00,396313.4,982.6500000004307
Sell,95,4157.47,2021-11-18 13:15:00,394959.65,395942.30000000045
Buy,95,4157.47,2021-11-18 13:15:00,394959.65,982.6500000004307
Sell,95,4188.48,2021-11-18 13:30:00,397905.6,398888.2500000004
Buy,95,4188.48,2021-11-18 13:30:00,397905.6,982.6500000004307
Sell,95,4173.77,2021-11-18 13:45:00,396508.15,397490.80000000045
Buy,95,4173.77,2021-11-18 13:45:00,396508.15,982.6500000004307
Sell,95,4158.67,2021-11-18 14:00:00,395073.65,396056.30000000045
Buy,95,4158.67,2021-11-18 14:00:00,395073.65,982.6500000004307
Sell,95,4156.11,2021-11-18 14:15:00,394830.44999999995,395813.1000000004
Buy,95,4156.11,2021-11-18 14:15:00,394830.44999999995,982.6500000004307
Sell,95,4135.82,2021-11-18 14:30:00,392902.89999999997,393885.5500000004
Buy,95,4135.82,2021-11-18 14:30:00,392902.89999999997,982.6500000004307
Sell,95,4141.53,2021-11-18 14:45:00,393445.35,394428.0000000004
Buy,95,4141.53,2021-11-18 14:45:00,393445.35,982.6500000004307
Sell,95,4118.97,2021-11-18 15:00:00,391302.15,392284.80000000045
Buy,95,4118.97,2021-11-18 15:00:00,391302.15,982.6500000004307
Sell,95,3805.72,2021-11-18 15:15:00,361543.39999999997,362526.0500000004
Buy,89,4070.65,2021-11-18 15:45:00,362287.85000000003,238.2000000003609
Sell,89,4074.93,2021-11-18 16:00:00,362668.76999999996,362906.9700000003
Buy,89,4074.93,2021-11-18 16:00:00,362668.76999999996,238.2000000003609
Sell,89,4032.5,2021-11-18 16:15:00,358892.5,359130.70000000036
Buy,89,4032.5,2021-11-18 16:15:00,358892.5,238.2000000003609
Sell,89,4024.74,2021-11-18 16:30:00,358201.86,358440.06000000035
Buy,88,4065.9,2021-11-18 17:30:00,357799.2,640.8600000003353
Sell,88,4038.03,2021-11-18 17:45:00,355346.64,355987.50000000035
Buy,88,4038.03,2021-11-18 17:45:00,355346.64,640.8600000003353
Sell,88,3805.72,2021-11-18 18:00:00,334903.36,335544.2200000003
Buy,82,4055.68,2021-11-18 18:30:00,332565.76,2978.460000000312
Sell,82,4073.94,2021-11-18 18:45:00,334063.08,337041.5400000003
Buy,82,4073.94,2021-11-18 18:45:00,334063.08,2978.460000000312
Sell,82,4078.57,2021-11-18 19:00:00,334442.74,337421.2000000003
Buy,82,4078.57,2021-11-18 19:00:00,334442.74,2978.460000000312
Sell,82,4076.32,2021-11-18 19:15:00,334258.24,337236.7000000003
Buy,82,4076.32,2021-11-18 19:15:00,334258.24,2978.460000000312
Sell,82,4077.5,2021-11-18 19:30:00,334355.0,337333.4600000003
Buy,82,4077.5,2021-11-18 19:30:00,334355.0,2978.460000000312
Sell,82,4066.37,2021-11-18 19:45:00,333442.33999999997,336420.8000000003
Buy,82,4066.37,2021-11-18 19:45:00,333442.33999999997,2978.460000000312
Sell,82,4051.93,2021-11-18 20:00:00,332258.26,335236.7200000003
Buy,82,4051.93,2021-11-18 20:00:00,332258.26,2978.460000000312
Sell,82,4059.64,2021-11-18 20:15:00,332890.48,335868.9400000003
Buy,82,4059.64,2021-11-18 20:15:00,332890.48,2978.460000000312
Sell,82,4081.43,2021-11-18 20:30:00,334677.26,337655.7200000003
Buy,82,4081.43,2021-11-18 20:30:00,334677.26,2978.460000000312
Sell,82,4060.38,2021-11-18 20:45:00,332951.16000000003,335929.62000000034
Buy,82,4060.38,2021-11-18 20:45:00,332951.16000000003,2978.460000000312
Sell,82,4069.42,2021-11-18 21:00:00,333692.44,336670.9000000003
Buy,82,4069.42,2021-11-18 21:00:00,333692.44,2978.460000000312
Sell,82,4051.82,2021-11-18 21:15:00,332249.24,335227.7000000003
Buy,82,4051.82,2021-11-18 21:15:00,332249.24,2978.460000000312
Sell,82,4038.64,2021-11-18 21:30:00,331168.48,334146.9400000003
Buy,83,4020.43,2021-11-18 21:45:00,333695.69,451.25000000029104
Sell,83,4013.82,2021-11-18 22:00:00,333147.06,333598.3100000003
Buy,83,3982.18,2021-11-18 22:30:00,330520.94,3077.3700000002864
Sell,83,3973.7,2021-11-18 22:45:00,329817.1,332894.47000000026
Buy,82,4028.42,2021-11-19 00:15:00,330330.44,2564.0300000002608
Sell,82,4097.44,2021-11-19 00:30:00,335990.07999999996,338554.1100000002
Buy,82,4097.44,2021-11-19 00:30:00,335990.07999999996,2564.0300000002608
Sell,82,4103.59,2021-11-19 00:45:00,336494.38,339058.41000000027
Buy,82,4103.59,2021-11-19 00:45:00,336494.38,2564.0300000002608
Sell,82,4090.22,2021-11-19 01:00:00,335398.04,337962.07000000024
Buy,82,4090.22,2021-11-19 01:00:00,335398.04,2564.0300000002608
Sell,82,4063.77,2021-11-19 01:15:00,333229.14,335793.1700000003
Buy,82,4063.77,2021-11-19 01:15:00,333229.14,2564.0300000002608
Sell,82,4056.32,2021-11-19 01:30:00,332618.24,335182.27000000025
Buy,82,4056.32,2021-11-19 01:30:00,332618.24,2564.0300000002608
Sell,82,4040.72,2021-11-19 01:45:00,331339.04,333903.07000000024
Buy,82,4040.72,2021-11-19 01:45:00,331339.04,2564.0300000002608
Sell,82,4056.9,2021-11-19 02:00:00,332665.8,335229.83000000025
Buy,82,4056.9,2021-11-19 02:00:00,332665.8,2564.0300000002608
Sell,82,4046.01,2021-11-19 02:15:00,331772.82,334336.85000000027
Buy,82,4046.01,2021-11-19 02:15:00,331772.82,2564.0300000002608
Sell,82,4023.55,2021-11-19 02:30:00,329931.10000000003,332495.1300000003
Buy,82,4023.55,2021-11-19 02:30:00,329931.10000000003,2564.0300000002608
Sell,82,4006.59,2021-11-19 02:45:00,328540.38,331104.41000000027
Buy,82,4006.59,2021-11-19 02:45:00,328540.38,2564.0300000002608
Sell,82,4023.7,2021-11-19 03:00:00,329943.39999999997,332507.4300000002
Buy,82,4023.7,2021-11-19 03:00:00,329943.39999999997,2564.0300000002608
Sell,82,4003.47,2021-11-19 03:15:00,328284.54,330848.57000000024
Buy,82,4003.47,2021-11-19 03:15:00,328284.54,2564.0300000002608
Sell,82,3985.2,2021-11-19 03:30:00,326786.39999999997,329350.4300000002
Buy,81,4022.03,2021-11-19 04:00:00,325784.43,3566.000000000233
Sell,81,4041.06,2021-11-19 04:15:00,327325.86,330891.8600000002
Buy,81,4041.06,2021-11-19 04:15:00,327325.86,3566.000000000233
Sell,81,4045.0,2021-11-19 04:30:00,327645.0,331211.00000000023
Buy,81,4045.0,2021-11-19 04:30:00,327645.0,3566.000000000233
Sell,81,4053.46,2021-11-19 04:45:00,328330.26,331896.26000000024
Buy,81,4053.46,2021-11-19 04:45:00,328330.26,3566.000000000233
Sell,81,4052.0,2021-11-19 05:00:00,328212.0,331778.00000000023
Buy,81,4052.0,2021-11-19 05:00:00,328212.0,3566.000000000233
Sell,81,4037.76,2021-11-19 05:15:00,327058.56,330624.56000000023
Buy,81,4037.76,2021-11-19 05:15:00,327058.56,3566.000000000233
Sell,81,4077.85,2021-11-19 05:30:00,330305.85,333871.8500000002
Buy,81,4077.85,2021-11-19 05:30:00,330305.85,3566.000000000233
Sell,81,4079.01,2021-11-19 05:45:00,330399.81,333965.81000000023
Buy,81,4079.01,2021-11-19 05:45:00,330399.81,3566.000000000233
Sell,81,4075.46,2021-11-19 06:00:00,330112.26,333678.26000000024
Buy,81,4075.46,2021-11-19 06:00:00,330112.26,3566.000000000233
Sell,81,4069.71,2021-11-19 06:15:00,329646.51,333212.51000000024
Buy,81,4069.71,2021-11-19 06:15:00,329646.51,3566.000000000233
Sell,81,4055.96,2021-11-19 06:30:00,328532.76,332098.76000000024
Buy,81,4055.96,2021-11-19 06:30:00,328532.76,3566.000000000233
Sell,81,4062.11,2021-11-19 06:45:00,329030.91000000003,332596.91000000027
Buy,81,4062.11,2021-11-19 06:45:00,329030.91000000003,3566.000000000233
Sell,81,4046.57,2021-11-19 07:00:00,327772.17000000004,331338.1700000003
Buy,81,4046.57,2021-11-19 07:00:00,327772.17000000004,3566.000000000233
Sell,81,4048.76,2021-11-19 07:15:00,327949.56,331515.56000000023
Buy,81,4056.49,2021-11-19 07:30:00,328575.69,2939.870000000228
Sell,81,4063.11,2021-11-19 07:45:00,329111.91000000003,332051.78000000026
Buy,81,4063.11,2021-11-19 07:45:00,329111.91000000003,2939.870000000228
Sell,81,4094.81,2021-11-19 08:00:00,331679.61,334619.4800000002
Buy,81,4094.81,2021-11-19 08:00:00,331679.61,2939.870000000228
Sell,81,4157.39,2021-11-19 08:15:00,336748.59,339688.46000000025
Buy,81,4157.39,2021-11-19 08:15:00,336748.59,2939.870000000228
Sell,81,4157.35,2021-11-19 08:30:00,336745.35000000003,339685.22000000026
Buy,81,4157.35,2021-11-19 08:30:00,336745.35000000003,2939.870000000228
Sell,81,4142.17,2021-11-19 08:45:00,335515.77,338455.64000000025
Buy,81,4142.17,2021-11-19 08:45:00,335515.77,2939.870000000228
Sell,81,4161.17,2021-11-19 09:00:00,337054.77,339994.64000000025
Buy,81,4161.17,2021-11-19 09:00:00,337054.77,2939.870000000228
Sell,81,4154.41,2021-11-19 09:15:00,336507.20999999996,339447.0800000002
Buy,81,4154.41,2021-11-19 09:15:00,336507.20999999996,2939.870000000228
Sell,81,4166.97,2021-11-19 09:30:00,337524.57,340464.44000000024
Buy,81,4166.97,2021-11-19 09:30:00,337524.57,2939.870000000228
Sell,81,4154.95,2021-11-19 09:45:00,336550.95,339490.82000000024
Buy,81,4154.95,2021-11-19 09:45:00,336550.95,2939.870000000228
Sell,81,4137.74,2021-11-19 10:00:00,335156.94,338096.81000000023
Buy,81,4137.74,2021-11-19 10:00:00,335156.94,2939.870000000228
Sell,81,4143.96,2021-11-19 10:15:00,335660.76,338600.63000000024
Buy,81,4143.96,2021-11-19 10:15:00,335660.76,2939.870000000228
Sell,81,4136.56,2021-11-19 10:30:00,335061.36000000004,338001.2300000003
Buy,81,4136.56,2021-11-19 10:30:00,335061.36000000004,2939.870000000228
Sell,81,4146.3,2021-11-19 10:45:00,335850.3,338790.1700000002
Buy,81,4146.3,2021-11-19 10:45:00,335850.3,2939.870000000228
Sell,81,4117.38,2021-11-19 11:00:00,333507.78,336447.65000000026
Buy,81,4117.38,2021-11-19 11:00:00,333507.78,2939.870000000228
Sell,81,4125.96,2021-11-19 11:15:00,334202.76,337142.63000000024
Buy,81,4125.96,2021-11-19 11:15:00,334202.76,2939.870000000228
Sell,81,4136.98,2021-11-19 11:30:00,335095.37999999995,338035.2500000002
Buy,81,4136.98,2021-11-19 11:30:00,335095.37999999995,2939.870000000228
Sell,81,4142.77,2021-11-19 11:45:00,335564.37000000005,338504.2400000003
Buy,81,4142.77,2021-11-19 11:45:00,335564.37000000005,2939.870000000228
Sell,81,4161.43,2021-11-19 12:00:00,337075.83,340015.70000000024
Buy,81,4161.43,2021-11-19 12:00:00,337075.83,2939.870000000228
Sell,81,4171.59,2021-11-19 12:15:00,337898.79000000004,340838.66000000027
Buy,81,4171.59,2021-11-19 12:15:00,337898.79000000004,2939.870000000228
Sell,81,4156.8,2021-11-19 12:30:00,336700.8,339640.6700000002
Buy,81,4156.8,2021-11-19 12:30:00,336700.8,2939.870000000228
Sell,81,4142.05,2021-11-19 12:45:00,335506.05,338445.9200000002
Buy,81,4142.05,2021-11-19 12:45:00,335506.05,2939.870000000228
Sell,81,4156.69,2021-11-19 13:00:00,336691.88999999996,339631.7600000002
Buy,81,4156.69,2021-11-19 13:00:00,336691.88999999996,2939.870000000228
Sell,81,4178.89,2021-11-19 13:15:00,338490.09,341429.96000000025
Buy,81,4178.89,2021-11-19 13:15:00,338490.09,2939.870000000228
Sell,81,4183.83,2021-11-19 13:30:00,338890.23,341830.1000000002
Buy,81,4183.83,2021-11-19 13:30:00,338890.23,2939.870000000228
Sell,81,4205.73,2021-11-19 13:45:00,340664.12999999995,343604.0000000002
Buy,81,4205.73,2021-11-19 13:45:00,340664.12999999995,2939.870000000228
Sell,81,4212.73,2021-11-19 14:00:00,341231.12999999995,344171.0000000002
Buy,81,4212.73,2021-11-19 14:00:00,341231.12999999995,2939.870000000228
Sell,81,4200.41,2021-11-19 14:15:00,340233.20999999996,343173.0800000002
Buy,81,4200.41,2021-11-19 14:15:00,340233.20999999996,2939.870000000228
Sell,81,4220.29,2021-11-19 14:30:00,341843.49,344783.3600000002
Buy,81,4220.29,2021-11-19 14:30:00,341843.49,2939.870000000228
Sell,81,4232.61,2021-11-19 14:45:00,342841.41,345781.2800000002
Buy,81,4232.61,2021-11-19 14:45:00,342841.41,2939.870000000228
Sell,81,4213.39,2021-11-19 15:00:00,341284.59,344224.46000000025
Buy,81,4213.39,2021-11-19 15:00:00,341284.59,2939.870000000228
Sell,81,4211.29,2021-11-19 15:15:00,341114.49,344054.3600000002
Buy,81,4211.29,2021-11-19 15:15:00,341114.49,2939.870000000228
Sell,81,4228.08,2021-11-19 15:30:00,342474.48,345414.3500000002
Buy,81,4228.08,2021-11-19 15:30:00,342474.48,2939.870000000228
Sell,81,4216.87,2021-11-19 15:45:00,341566.47,344506.3400000002
Buy,81,4216.87,2021-11-19 15:45:00,341566.47,2939.870000000228
Sell,81,4226.89,2021-11-19 16:00:00,342378.09,345317.96000000025
Buy,81,4226.89,2021-11-19 16:00:00,342378.09,2939.870000000228
Sell,81,4212.59,2021-11-19 16:15:00,341219.79000000004,344159.66000000027
Buy,81,4212.59,2021-11-19 16:15:00,341219.79000000004,2939.870000000228
Sell,81,4230.98,2021-11-19 16:30:00,342709.37999999995,345649.2500000002
Buy,81,4230.98,2021-11-19 16:30:00,342709.37999999995,2939.870000000228
Sell,81,4250.58,2021-11-19 16:45:00,344296.98,347236.8500000002
Buy,81,4250.58,2021-11-19 16:45:00,344296.98,2939.870000000228
Sell,81,4269.74,2021-11-19 17:00:00,345848.94,348788.81000000023
Buy,81,4269.74,2021-11-19 17:00:00,345848.94,2939.870000000228
Sell,81,4274.65,2021-11-19 17:15:00,346246.64999999997,349186.5200000002
Buy,81,4274.65,2021-11-19 17:15:00,346246.64999999997,2939.870000000228
Sell,81,4261.96,2021-11-19 17:30:00,345218.76,348158.63000000024
Buy,81,4261.96,2021-11-19 17:30:00,345218.76,2939.870000000228
Sell,81,4253.97,2021-11-19 17:45:00,344571.57,347511.44000000024
Buy,81,4253.97,2021-11-19 17:45:00,344571.57,2939.870000000228
Sell,81,4262.78,2021-11-19 18:00:00,345285.18,348225.0500000002
Buy,81,4262.78,2021-11-19 18:00:00,345285.18,2939.870000000228
Sell,81,4253.95,2021-11-19 18:15:00,344569.95,347509.82000000024
Buy,81,4253.95,2021-11-19 18:15:00,344569.95,2939.870000000228
Sell,81,4256.26,2021-11-19 18:30:00,344757.06,347696.9300000002
Buy,81,4256.26,2021-11-19 18:30:00,344757.06,2939.870000000228
Sell,81,4264.28,2021-11-19 18:45:00,345406.68,348346.5500000002
Buy,81,4264.28,2021-11-19 18:45:00,345406.68,2939.870000000228
Sell,81,4273.22,2021-11-19 19:00:00,346130.82,349070.69000000024
Buy,81,4273.22,2021-11-19 19:00:00,346130.82,2939.870000000228
Sell,81,4264.8,2021-11-19 19:15:00,345448.8,348388.6700000002
Buy,81,4264.8,2021-11-19 19:15:00,345448.8,2939.870000000228
Sell,81,4270.37,2021-11-19 19:30:00,345899.97,348839.8400000002
Buy,81,4270.37,2021-11-19 19:30:00,345899.97,2939.870000000228
Sell,81,4289.5,2021-11-19 19:45:00,347449.5,350389.3700000002
Buy,81,4289.5,2021-11-19 19:45:00,347449.5,2939.870000000228
Sell,81,4292.76,2021-11-19 20:00:00,347713.56,350653.4300000002
Buy,81,4292.76,2021-11-19 20:00:00,347713.56,2939.870000000228
Sell,81,4278.8,2021-11-19 20:15:00,346582.8,349522.6700000002
Buy,81,4278.8,2021-11-19 20:15:00,346582.8,2939.870000000228
Sell,81,4273.98,2021-11-19 20:30:00,346192.37999999995,349132.2500000002
Buy,81,4273.98,2021-11-19 20:30:00,346192.37999999995,2939.870000000228
Sell,81,4267.39,2021-11-19 20:45:00,345658.59,348598.46000000025
Buy,81,4267.39,2021-11-19 20:45:00,345658.59,2939.870000000228
Sell,81,4261.89,2021-11-19 21:00:00,345213.09,348152.96000000025
Buy,81,4261.89,2021-11-19 21:00:00,345213.09,2939.870000000228
Sell,81,4255.88,2021-11-19 21:15:00,344726.28,347666.15000000026
Buy,81,4255.88,2021-11-19 21:15:00,344726.28,2939.870000000228
Sell,81,4262.05,2021-11-19 21:30:00,345226.05,348165.9200000002
Buy,81,4262.05,2021-11-19 21:30:00,345226.05,2939.870000000228
Sell,81,4275.47,2021-11-19 21:45:00,346313.07,349252.94000000024
Buy,81,4275.47,2021-11-19 21:45:00,346313.07,2939.870000000228
Sell,81,4294.31,2021-11-19 22:00:00,347839.11000000004,350778.9800000003
Buy,81,4294.31,2021-11-19 22:00:00,347839.11000000004,2939.870000000228
Sell,81,4304.03,2021-11-19 22:15:00,348626.43,351566.3000000002
Buy,81,4304.03,2021-11-19 22:15:00,348626.43,2939.870000000228
Sell,81,4286.14,2021-11-19 22:30:00,347177.34,350117.21000000025
Buy,81,4286.14,2021-11-19 22:30:00,347177.34,2939.870000000228
Sell,81,4278.92,2021-11-19 22:45:00,346592.52,349532.39000000025
Buy,81,4278.92,2021-11-19 22:45:00,346592.52,2939.870000000228
Sell,81,4296.24,2021-11-19 23:00:00,347995.44,350935.31000000023
Buy,81,4296.24,2021-11-19 23:00:00,347995.44,2939.870000000228
Sell,81,4289.71,2021-11-19 23:15:00,347466.51,350406.38000000024
Buy,81,4289.71,2021-11-19 23:15:00,347466.51,2939.870000000228
Sell,81,4273.71,2021-11-19 23:30:00,346170.51,349110.38000000024
Buy,81,4273.71,2021-11-19 23:30:00,346170.51,2939.870000000228
Sell,81,4293.44,2021-11-19 23:45:00,347768.63999999996,350708.5100000002
Buy,81,4293.44,2021-11-19 23:45:00,347768.63999999996,2939.870000000228
Sell,81,4320.26,2021-11-20 00:00:00,349941.06,352880.9300000002
Buy,81,4320.26,2021-11-20 00:00:00,349941.06,2939.870000000228
Sell,81,4316.51,2021-11-20 00:15:00,349637.31,352577.1800000002
Buy,81,4316.51,2021-11-20 00:15:00,349637.31,2939.870000000228
Sell,81,4296.47,2021-11-20 00:30:00,348014.07,350953.94000000024
Buy,81,4296.47,2021-11-20 00:30:00,348014.07,2939.870000000228
Sell,81,4297.3,2021-11-20 00:45:00,348081.3,351021.1700000002
Buy,81,4297.3,2021-11-20 00:45:00,348081.3,2939.870000000228
Sell,81,4315.23,2021-11-20 01:00:00,349533.62999999995,352473.5000000002
Buy,81,4315.23,2021-11-20 01:00:00,349533.62999999995,2939.870000000228
Sell,81,4326.06,2021-11-20 01:15:00,350410.86000000004,353350.7300000003
Buy,81,4326.06,2021-11-20 01:15:00,350410.86000000004,2939.870000000228
Sell,81,4318.49,2021-11-20 01:30:00,349797.69,352737.56000000023
Buy,81,4318.49,2021-11-20 01:30:00,349797.69,2939.870000000228
Sell,81,4325.5,2021-11-20 01:45:00,350365.5,353305.3700000002
Buy,81,4325.5,2021-11-20 01:45:00,350365.5,2939.870000000228
Sell,81,4323.72,2021-11-20 02:00:00,350221.32,353161.19000000024
Buy,81,4323.72,2021-11-20 02:00:00,350221.32,2939.870000000228
Sell,81,4319.15,2021-11-20 02:15:00,349851.14999999997,352791.0200000002
Buy,81,4319.15,2021-11-20 02:15:00,349851.14999999997,2939.870000000228
Sell,81,4312.39,2021-11-20 02:30:00,349303.59,352243.46000000025
Buy,81,4312.39,2021-11-20 02:30:00,349303.59,2939.870000000228
Sell,81,4306.01,2021-11-20 02:45:00,348786.81,351726.6800000002
Buy,81,4306.01,2021-11-20 02:45:00,348786.81,2939.870000000228
Sell,81,4304.6,2021-11-20 03:00:00,348672.60000000003,351612.47000000026
Buy,81,4304.6,2021-11-20 03:00:00,348672.60000000003,2939.870000000228
Sell,81,4302.37,2021-11-20 03:15:00,348491.97,351431.8400000002
Buy,81,4302.37,2021-11-20 03:15:00,348491.97,2939.870000000228
Sell,81,4284.87,2021-11-20 03:30:00,347074.47,350014.3400000002
Buy,81,4284.87,2021-11-20 03:30:00,347074.47,2939.870000000228
Sell,81,4281.64,2021-11-20 03:45:00,346812.84,349752.71000000025
Buy,81,4281.64,2021-11-20 03:45:00,346812.84,2939.870000000228
Sell,81,4275.0,2021-11-20 04:00:00,346275.0,349214.8700000002
Buy,81,4275.0,2021-11-20 04:00:00,346275.0,2939.870000000228
Sell,81,4267.63,2021-11-20 04:15:00,345678.03,348617.90000000026
Buy,81,4267.63,2021-11-20 04:15:00,345678.03,2939.870000000228
Sell,81,4282.64,2021-11-20 04:30:00,346893.84,349833.71000000025
Buy,81,4282.64,2021-11-20 04:30:00,346893.84,2939.870000000228
Sell,81,4291.52,2021-11-20 04:45:00,347613.12000000005,350552.9900000003
Buy,81,4291.52,2021-11-20 04:45:00,347613.12000000005,2939.870000000228
Sell,81,4276.48,2021-11-20 05:00:00,346394.87999999995,349334.7500000002
Buy,81,4276.48,2021-11-20 05:00:00,346394.87999999995,2939.870000000228
Sell,81,4283.49,2021-11-20 05:15:00,346962.69,349902.56000000023
Buy,81,4283.49,2021-11-20 05:15:00,346962.69,2939.870000000228
Sell,81,4286.5,2021-11-20 05:30:00,347206.5,350146.3700000002
Buy,81,4286.5,2021-11-20 05:30:00,347206.5,2939.870000000228
Sell,81,4276.18,2021-11-20 05:45:00,346370.58,349310.45000000024
Buy,81,4276.18,2021-11-20 05:45:00,346370.58,2939.870000000228
Sell,81,4282.34,2021-11-20 06:00:00,346869.54000000004,349809.41000000027
Buy,81,4282.34,2021-11-20 06:00:00,346869.54000000004,2939.870000000228
Sell,81,4306.7,2021-11-20 06:15:00,348842.7,351782.57000000024
Buy,81,4306.7,2021-11-20 06:15:00,348842.7,2939.870000000228
Sell,81,4295.19,2021-11-20 06:30:00,347910.38999999996,350850.2600000002
Buy,81,4295.19,2021-11-20 06:30:00,347910.38999999996,2939.870000000228
Sell,81,4293.57,2021-11-20 06:45:00,347779.17,350719.0400000002
Buy,81,4293.57,2021-11-20 06:45:00,347779.17,2939.870000000228
Sell,81,4296.5,2021-11-20 07:00:00,348016.5,350956.3700000002
Buy,81,4296.5,2021-11-20 07:00:00,348016.5,2939.870000000228
Sell,81,4279.51,2021-11-20 07:15:00,346640.31,349580.1800000002
Buy,81,4279.51,2021-11-20 07:15:00,346640.31,2939.870000000228
Sell,81,4285.16,2021-11-20 07:30:00,347097.95999999996,350037.8300000002
Buy,81,4285.16,2021-11-20 07:30:00,347097.95999999996,2939.870000000228
Sell,81,4281.04,2021-11-20 07:45:00,346764.24,349704.1100000002
Buy,81,4281.04,2021-11-20 07:45:00,346764.24,2939.870000000228
Sell,81,4278.47,2021-11-20 08:00:00,346556.07,349495.94000000024
Buy,81,4278.47,2021-11-20 08:00:00,346556.07,2939.870000000228
Sell,81,4285.75,2021-11-20 08:15:00,347145.75,350085.6200000002
Buy,81,4285.75,2021-11-20 08:15:00,347145.75,2939.870000000228
Sell,81,4304.98,2021-11-20 08:30:00,348703.37999999995,351643.2500000002
Buy,81,4304.98,2021-11-20 08:30:00,348703.37999999995,2939.870000000228
Sell,81,4290.52,2021-11-20 08:45:00,347532.12000000005,350471.9900000003
Buy,81,4290.52,2021-11-20 08:45:00,347532.12000000005,2939.870000000228
Sell,81,4305.67,2021-11-20 09:00:00,348759.27,351699.14000000025
Buy,81,4305.67,2021-11-20 09:00:00,348759.27,2939.870000000228
Sell,81,4290.21,2021-11-20 09:15:00,347507.01,350446.88000000024
Buy,81,4290.21,2021-11-20 09:15:00,347507.01,2939.870000000228
Sell,81,4294.61,2021-11-20 09:30:00,347863.41,350803.2800000002
Buy,81,4294.61,2021-11-20 09:30:00,347863.41,2939.870000000228
Sell,81,4291.26,2021-11-20 09:45:00,347592.06,350531.9300000002
Buy,81,4291.26,2021-11-20 09:45:00,347592.06,2939.870000000228
Sell,81,4292.91,2021-11-20 10:00:00,347725.70999999996,350665.5800000002
Buy,81,4292.91,2021-11-20 10:00:00,347725.70999999996,2939.870000000228
Sell,81,4308.52,2021-11-20 10:15:00,348990.12000000005,351929.9900000003
Buy,81,4308.52,2021-11-20 10:15:00,348990.12000000005,2939.870000000228
Sell,81,4305.48,2021-11-20 10:30:00,348743.87999999995,351683.7500000002
Buy,81,4305.48,2021-11-20 10:30:00,348743.87999999995,2939.870000000228
Sell,81,4295.88,2021-11-20 10:45:00,347966.28,350906.15000000026
Buy,81,4295.88,2021-11-20 10:45:00,347966.28,2939.870000000228
Sell,81,4315.0,2021-11-20 11:00:00,349515.0,352454.8700000002
Buy,81,4315.0,2021-11-20 11:00:00,349515.0,2939.870000000228
Sell,81,4301.13,2021-11-20 11:15:00,348391.53,351331.40000000026
Buy,81,4301.13,2021-11-20 11:15:00,348391.53,2939.870000000228
Sell,81,4311.44,2021-11-20 11:30:00,349226.63999999996,352166.5100000002
Buy,81,4311.44,2021-11-20 11:30:00,349226.63999999996,2939.870000000228
Sell,81,4317.82,2021-11-20 11:45:00,349743.42,352683.2900000002
Buy,81,4317.82,2021-11-20 11:45:00,349743.42,2939.870000000228
Sell,81,4328.21,2021-11-20 12:00:00,350585.01,353524.88000000024
Buy,81,4328.21,2021-11-20 12:00:00,350585.01,2939.870000000228
Sell,81,4324.01,2021-11-20 12:15:00,350244.81,353184.6800000002
Buy,81,4324.01,2021-11-20 12:15:00,350244.81,2939.870000000228
Sell,81,4311.5,2021-11-20 12:30:00,349231.5,352171.3700000002
Buy,81,4311.5,2021-11-20 12:30:00,349231.5,2939.870000000228
Sell,81,4312.37,2021-11-20 12:45:00,349301.97,352241.8400000002
Buy,81,4312.37,2021-11-20 12:45:00,349301.97,2939.870000000228
Sell,81,4313.5,2021-11-20 13:00:00,349393.5,352333.3700000002
Buy,81,4313.5,2021-11-20 13:00:00,349393.5,2939.870000000228
Sell,81,4307.01,2021-11-20 13:15:00,348867.81,351807.6800000002
Buy,81,4307.01,2021-11-20 13:15:00,348867.81,2939.870000000228
Sell,81,4293.64,2021-11-20 13:30:00,347784.84,350724.71000000025
Buy,81,4293.64,2021-11-20 13:30:00,347784.84,2939.870000000228
Sell,81,4296.78,2021-11-20 13:45:00,348039.18,350979.0500000002
Buy,81,4296.78,2021-11-20 13:45:00,348039.18,2939.870000000228
Sell,81,4310.82,2021-11-20 14:00:00,349176.42,352116.2900000002
Buy,81,4310.82,2021-11-20 14:00:00,349176.42,2939.870000000228
Sell,81,4299.01,2021-11-20 14:15:00,348219.81,351159.6800000002
Buy,81,4299.01,2021-11-20 14:15:00,348219.81,2939.870000000228
Sell,81,4300.77,2021-11-20 14:30:00,348362.37000000005,351302.2400000003
Buy,81,4300.77,2021-11-20 14:30:00,348362.37000000005,2939.870000000228
Sell,81,4286.07,2021-11-20 14:45:00,347171.67,350111.5400000002
Buy,81,4286.07,2021-11-20 14:45:00,347171.67,2939.870000000228
Sell,81,4240.79,2021-11-20 15:00:00,343503.99,346443.8600000002
Buy,81,4240.79,2021-11-20 15:00:00,343503.99,2939.870000000228
Sell,81,4254.45,2021-11-20 15:15:00,344610.45,347550.32000000024
Buy,81,4254.45,2021-11-20 15:15:00,344610.45,2939.870000000228
Sell,81,4228.88,2021-11-20 15:30:00,342539.28,345479.15000000026
Buy,81,4228.88,2021-11-20 15:30:00,342539.28,2939.870000000228
Sell,81,4215.77,2021-11-20 15:45:00,341477.37000000005,344417.2400000003
Buy,81,4215.77,2021-11-20 15:45:00,341477.37000000005,2939.870000000228
Sell,81,4213.61,2021-11-20 16:00:00,341302.41,344242.2800000002
Buy,81,4213.61,2021-11-20 16:00:00,341302.41,2939.870000000228
Sell,81,4229.24,2021-11-20 16:15:00,342568.44,345508.31000000023
Buy,81,4229.24,2021-11-20 16:15:00,342568.44,2939.870000000228
Sell,81,4239.18,2021-11-20 16:30:00,343373.58,346313.45000000024
Buy,81,4239.18,2021-11-20 16:30:00,343373.58,2939.870000000228
Sell,81,4243.49,2021-11-20 16:45:00,343722.69,346662.56000000023
Buy,81,4243.49,2021-11-20 16:45:00,343722.69,2939.870000000228
Sell,81,4238.53,2021-11-20 17:00:00,343320.93,346260.8000000002
Buy,81,4238.53,2021-11-20 17:00:00,343320.93,2939.870000000228
Sell,81,4234.22,2021-11-20 17:15:00,342971.82,345911.69000000024
Buy,81,4234.22,2021-11-20 17:15:00,342971.82,2939.870000000228
Sell,81,4239.61,2021-11-20 17:30:00,343408.41,346348.2800000002
Buy,81,4239.61,2021-11-20 17:30:00,343408.41,2939.870000000228
Sell,81,4251.68,2021-11-20 17:45:00,344386.08,347325.95000000024
Buy,81,4251.68,2021-11-20 17:45:00,344386.08,2939.870000000228
Sell,81,4271.43,2021-11-20 18:00:00,345985.83,348925.70000000024
Buy,81,4271.43,2021-11-20 18:00:00,345985.83,2939.870000000228
Sell,81,4381.34,2021-11-20 18:15:00,354888.54000000004,357828.41000000027
Buy,81,4381.34,2021-11-20 18:15:00,354888.54000000004,2939.870000000228
Sell,81,4386.25,2021-11-20 18:30:00,355286.25,358226.1200000002
Buy,81,4386.25,2021-11-20 18:30:00,355286.25,2939.870000000228
Sell,81,4371.13,2021-11-20 18:45:00,354061.53,357001.40000000026
Buy,81,4371.13,2021-11-20 18:45:00,354061.53,2939.870000000228
Sell,81,4375.58,2021-11-20 19:00:00,354421.98,357361.8500000002
Buy,81,4375.58,2021-11-20 19:00:00,354421.98,2939.870000000228
Sell,81,4374.03,2021-11-20 19:15:00,354296.43,357236.3000000002
Buy,81,4374.03,2021-11-20 19:15:00,354296.43,2939.870000000228
Sell,81,4386.71,2021-11-20 19:30:00,355323.51,358263.38000000024
Buy,81,4386.71,2021-11-20 19:30:00,355323.51,2939.870000000228
Sell,81,4398.27,2021-11-20 19:45:00,356259.87000000005,359199.7400000003
Buy,81,4398.27,2021-11-20 19:45:00,356259.87000000005,2939.870000000228
Sell,81,4394.01,2021-11-20 20:00:00,355914.81,358854.6800000002
Buy,81,4394.01,2021-11-20 20:00:00,355914.81,2939.870000000228
Sell,81,4401.33,2021-11-20 20:15:00,356507.73,359447.6000000002
Buy,81,4401.33,2021-11-20 20:15:00,356507.73,2939.870000000228
Sell,81,4399.54,2021-11-20 20:30:00,356362.74,359302.6100000002
Buy,81,4399.54,2021-11-20 20:30:00,356362.74,2939.870000000228
Sell,81,4407.14,2021-11-20 20:45:00,356978.34,359918.21000000025
Buy,81,4407.14,2021-11-20 20:45:00,356978.34,2939.870000000228
Sell,81,4418.81,2021-11-20 21:00:00,357923.61000000004,360863.4800000003
Buy,81,4418.81,2021-11-20 21:00:00,357923.61000000004,2939.870000000228
Sell,81,4416.98,2021-11-20 21:15:00,357775.37999999995,360715.2500000002
Buy,81,4416.98,2021-11-20 21:15:00,357775.37999999995,2939.870000000228
Sell,81,4420.06,2021-11-20 21:30:00,358024.86000000004,360964.7300000003
Buy,81,4420.06,2021-11-20 21:30:00,358024.86000000004,2939.870000000228
Sell,81,4427.84,2021-11-20 21:45:00,358655.04000000004,361594.91000000027
Buy,81,4427.84,2021-11-20 21:45:00,358655.04000000004,2939.870000000228
Sell,81,4420.21,2021-11-20 22:00:00,358037.01,360976.88000000024
Buy,81,4420.21,2021-11-20 22:00:00,358037.01,2939.870000000228
Sell,81,4416.89,2021-11-20 22:15:00,357768.09,360707.96000000025
Buy,81,4416.89,2021-11-20 22:15:00,357768.09,2939.870000000228
Sell,81,4413.23,2021-11-20 22:30:00,357471.62999999995,360411.5000000002
Buy,81,4413.23,2021-11-20 22:30:00,357471.62999999995,2939.870000000228
Sell,81,4411.55,2021-11-20 22:45:00,357335.55,360275.4200000002
Buy,81,4411.55,2021-11-20 22:45:00,357335.55,2939.870000000228
Sell,81,4408.98,2021-11-20 23:00:00,357127.37999999995,360067.2500000002
Buy,81,4408.98,2021-11-20 23:00:00,357127.37999999995,2939.870000000228
Sell,81,4397.17,2021-11-20 23:15:00,356170.77,359110.64000000025
Buy,81,4397.17,2021-11-20 23:15:00,356170.77,2939.870000000228
Sell,81,4411.45,2021-11-20 23:30:00,357327.45,360267.32000000024
Buy,81,4411.45,2021-11-20 23:30:00,357327.45,2939.870000000228
Sell,81,4412.55,2021-11-20 23:45:00,357416.55,360356.4200000002
Buy,81,4412.55,2021-11-20 23:45:00,357416.55,2939.870000000228
Sell,81,4413.98,2021-11-21 00:00:00,357532.37999999995,360472.2500000002
Buy,81,4413.98,2021-11-21 00:00:00,357532.37999999995,2939.870000000228
Sell,81,4396.63,2021-11-21 00:15:00,356127.03,359066.90000000026
Buy,81,4396.63,2021-11-21 00:15:00,356127.03,2939.870000000228
Sell,81,4404.18,2021-11-21 00:30:00,356738.58,359678.45000000024
Buy,81,4404.18,2021-11-21 00:30:00,356738.58,2939.870000000228
Sell,81,4392.17,2021-11-21 00:45:00,355765.77,358705.64000000025
Buy,81,4392.17,2021-11-21 00:45:00,355765.77,2939.870000000228
Sell,81,4389.91,2021-11-21 01:00:00,355582.70999999996,358522.5800000002
Buy,81,4389.91,2021-11-21 01:00:00,355582.70999999996,2939.870000000228
Sell,81,4387.66,2021-11-21 01:15:00,355400.45999999996,358340.3300000002
Buy,81,4387.66,2021-11-21 01:15:00,355400.45999999996,2939.870000000228
Sell,81,4383.44,2021-11-21 01:30:00,355058.63999999996,357998.5100000002
Buy,81,4383.44,2021-11-21 01:30:00,355058.63999999996,2939.870000000228
Sell,81,4376.59,2021-11-21 01:45:00,354503.79000000004,357443.66000000027
Buy,81,4376.59,2021-11-21 01:45:00,354503.79000000004,2939.870000000228
Sell,81,4368.39,2021-11-21 02:00:00,353839.59,356779.46000000025
Buy,81,4368.39,2021-11-21 02:00:00,353839.59,2939.870000000228
Sell,81,4364.23,2021-11-21 02:15:00,353502.62999999995,356442.5000000002
Buy,81,4364.23,2021-11-21 02:15:00,353502.62999999995,2939.870000000228
Sell,81,4344.83,2021-11-21 02:30:00,351931.23,354871.1000000002
Buy,81,4344.83,2021-11-21 02:30:00,351931.23,2939.870000000228
Sell,81,4368.24,2021-11-21 02:45:00,353827.44,356767.31000000023
Buy,81,4368.24,2021-11-21 02:45:00,353827.44,2939.870000000228
Sell,81,4378.27,2021-11-21 03:00:00,354639.87000000005,357579.7400000003
Buy,81,4378.27,2021-11-21 03:00:00,354639.87000000005,2939.870000000228
Sell,81,4372.01,2021-11-21 03:15:00,354132.81,357072.6800000002
Buy,81,4372.01,2021-11-21 03:15:00,354132.81,2939.870000000228
Sell,81,4356.03,2021-11-21 03:30:00,352838.43,355778.3000000002
Buy,81,4356.03,2021-11-21 03:30:00,352838.43,2939.870000000228
Sell,81,4344.35,2021-11-21 03:45:00,351892.35000000003,354832.22000000026
Buy,81,4344.35,2021-11-21 03:45:00,351892.35000000003,2939.870000000228
Sell,81,4362.16,2021-11-21 04:00:00,353334.95999999996,356274.8300000002
Buy,81,4362.16,2021-11-21 04:00:00,353334.95999999996,2939.870000000228
Sell,81,4357.29,2021-11-21 04:15:00,352940.49,355880.3600000002
Buy,81,4357.29,2021-11-21 04:15:00,352940.49,2939.870000000228
Sell,81,4344.6,2021-11-21 04:30:00,351912.60000000003,354852.47000000026
Buy,81,4344.6,2021-11-21 04:30:00,351912.60000000003,2939.870000000228
Sell,81,4330.93,2021-11-21 04:45:00,350805.33,353745.20000000024
Buy,81,4330.93,2021-11-21 04:45:00,350805.33,2939.870000000228
Sell,81,4345.01,2021-11-21 05:00:00,351945.81,354885.6800000002
Buy,81,4345.01,2021-11-21 05:00:00,351945.81,2939.870000000228
Sell,81,4343.31,2021-11-21 05:15:00,351808.11000000004,354747.9800000003
Buy,81,4343.31,2021-11-21 05:15:00,351808.11000000004,2939.870000000228
Sell,81,4358.3,2021-11-21 05:30:00,353022.3,355962.1700000002
Buy,81,4358.3,2021-11-21 05:30:00,353022.3,2939.870000000228
Sell,81,4367.17,2021-11-21 05:45:00,353740.77,356680.64000000025
Buy,81,4367.17,2021-11-21 05:45:00,353740.77,2939.870000000228
Sell,81,4365.4,2021-11-21 06:00:00,353597.39999999997,356537.2700000002
Buy,81,4365.4,2021-11-21 06:00:00,353597.39999999997,2939.870000000228
Sell,81,4356.43,2021-11-21 06:15:00,352870.83,355810.70000000024
Buy,81,4356.43,2021-11-21 06:15:00,352870.83,2939.870000000228
Sell,81,4356.99,2021-11-21 06:30:00,352916.19,355856.06000000023
Buy,81,4356.99,2021-11-21 06:30:00,352916.19,2939.870000000228
Sell,81,4381.99,2021-11-21 06:45:00,354941.19,357881.06000000023
Buy,81,4381.99,2021-11-21 06:45:00,354941.19,2939.870000000228
Sell,81,4369.38,2021-11-21 07:00:00,353919.78,356859.65000000026
Buy,81,4369.38,2021-11-21 07:00:00,353919.78,2939.870000000228
Sell,81,4362.25,2021-11-21 07:15:00,353342.25,356282.1200000002
Buy,81,4362.25,2021-11-21 07:15:00,353342.25,2939.870000000228
Sell,81,4360.03,2021-11-21 07:30:00,353162.43,356102.3000000002
Buy,81,4360.03,2021-11-21 07:30:00,353162.43,2939.870000000228
Sell,81,4349.66,2021-11-21 07:45:00,352322.45999999996,355262.3300000002
Buy,81,4349.66,2021-11-21 07:45:00,352322.45999999996,2939.870000000228
Sell,81,4347.11,2021-11-21 08:00:00,352115.91,355055.7800000002
Buy,81,4347.11,2021-11-21 08:00:00,352115.91,2939.870000000228
Sell,81,4351.91,2021-11-21 08:15:00,352504.70999999996,355444.5800000002
Buy,81,4351.91,2021-11-21 08:15:00,352504.70999999996,2939.870000000228
Sell,81,4361.6,2021-11-21 08:30:00,353289.60000000003,356229.47000000026
Buy,81,4361.6,2021-11-21 08:30:00,353289.60000000003,2939.870000000228
Sell,81,4340.78,2021-11-21 08:45:00,351603.18,354543.0500000002
Buy,81,4340.78,2021-11-21 08:45:00,351603.18,2939.870000000228
Sell,81,4351.33,2021-11-21 09:00:00,352457.73,355397.6000000002
Buy,81,4351.33,2021-11-21 09:00:00,352457.73,2939.870000000228
Sell,81,4358.83,2021-11-21 09:15:00,353065.23,356005.1000000002
Buy,81,4358.83,2021-11-21 09:15:00,353065.23,2939.870000000228
Sell,81,4349.26,2021-11-21 09:30:00,352290.06,355229.9300000002
Buy,81,4349.26,2021-11-21 09:30:00,352290.06,2939.870000000228
Sell,81,4352.47,2021-11-21 09:45:00,352550.07,355489.94000000024
Buy,81,4352.47,2021-11-21 09:45:00,352550.07,2939.870000000228
Sell,81,4347.04,2021-11-21 10:00:00,352110.24,355050.1100000002
Buy,81,4347.04,2021-11-21 10:00:00,352110.24,2939.870000000228
Sell,81,4347.4,2021-11-21 10:15:00,352139.39999999997,355079.2700000002
Buy,81,4347.4,2021-11-21 10:15:00,352139.39999999997,2939.870000000228
Sell,81,4310.1,2021-11-21 10:30:00,349118.10000000003,352057.97000000026
Buy,81,4310.1,2021-11-21 10:30:00,349118.10000000003,2939.870000000228
Sell,81,4322.0,2021-11-21 10:45:00,350082.0,353021.8700000002
Buy,81,4322.0,2021-11-21 10:45:00,350082.0,2939.870000000228
Sell,81,4342.56,2021-11-21 11:00:00,351747.36000000004,354687.2300000003
Buy,81,4342.56,2021-11-21 11:00:00,351747.36000000004,2939.870000000228
Sell,81,4309.59,2021-11-21 11:15:00,349076.79000000004,352016.66000000027
Buy,81,4309.59,2021-11-21 11:15:00,349076.79000000004,2939.870000000228
Sell,81,4320.96,2021-11-21 11:30:00,349997.76,352937.63000000024
Buy,81,4320.96,2021-11-21 11:30:00,349997.76,2939.870000000228
Sell,81,4320.45,2021-11-21 11:45:00,349956.45,352896.32000000024
Buy,81,4320.45,2021-11-21 11:45:00,349956.45,2939.870000000228
Sell,81,4337.36,2021-11-21 12:00:00,351326.16,354266.0300000002
Buy,81,4337.36,2021-11-21 12:00:00,351326.16,2939.870000000228
Sell,81,4340.8,2021-11-21 12:15:00,351604.8,354544.6700000002
Buy,81,4340.8,2021-11-21 12:15:00,351604.8,2939.870000000228
Sell,81,4333.31,2021-11-21 12:30:00,350998.11000000004,353937.9800000003
Buy,81,4333.31,2021-11-21 12:30:00,350998.11000000004,2939.870000000228
Sell,81,4330.86,2021-11-21 12:45:00,350799.66,353739.5300000002
Buy,81,4330.86,2021-11-21 12:45:00,350799.66,2939.870000000228
Sell,81,4328.37,2021-11-21 13:00:00,350597.97,353537.8400000002
Buy,81,4328.37,2021-11-21 13:00:00,350597.97,2939.870000000228
Sell,81,4335.1,2021-11-21 13:15:00,351143.10000000003,354082.97000000026
Buy,81,4335.1,2021-11-21 13:15:00,351143.10000000003,2939.870000000228
Sell,81,4324.93,2021-11-21 13:30:00,350319.33,353259.20000000024
Buy,81,4324.93,2021-11-21 13:30:00,350319.33,2939.870000000228
Sell,81,4318.01,2021-11-21 13:45:00,349758.81,352698.6800000002
Buy,81,4318.01,2021-11-21 13:45:00,349758.81,2939.870000000228
Sell,81,4313.26,2021-11-21 14:00:00,349374.06,352313.9300000002
Buy,81,4313.26,2021-11-21 14:00:00,349374.06,2939.870000000228
Sell,81,4311.01,2021-11-21 14:15:00,349191.81,352131.6800000002
Buy,81,4311.01,2021-11-21 14:15:00,349191.81,2939.870000000228
Sell,81,4328.88,2021-11-21 14:30:00,350639.28,353579.15000000026
Buy,81,4328.88,2021-11-21 14:30:00,350639.28,2939.870000000228
Sell,81,4331.97,2021-11-21 14:45:00,350889.57,353829.44000000024
Buy,81,4331.97,2021-11-21 14:45:00,350889.57,2939.870000000228
Sell,81,4337.01,2021-11-21 15:00:00,351297.81,354237.6800000002
Buy,81,4337.01,2021-11-21 15:00:00,351297.81,2939.870000000228
Sell,81,4358.66,2021-11-21 15:15:00,353051.45999999996,355991.3300000002
Buy,81,4358.66,2021-11-21 15:15:00,353051.45999999996,2939.870000000228
Sell,81,4375.03,2021-11-21 15:30:00,354377.43,357317.3000000002
Buy,81,4375.03,2021-11-21 15:30:00,354377.43,2939.870000000228
Sell,81,4367.9,2021-11-21 15:45:00,353799.89999999997,356739.7700000002
Buy,81,4367.9,2021-11-21 15:45:00,353799.89999999997,2939.870000000228
Sell,81,4363.14,2021-11-21 16:00:00,353414.34,356354.21000000025
Buy,81,4363.14,2021-11-21 16:00:00,353414.34,2939.870000000228
Sell,81,4340.28,2021-11-21 16:15:00,351562.68,354502.5500000002
Buy,81,4340.28,2021-11-21 16:15:00,351562.68,2939.870000000228
Sell,81,4353.92,2021-11-21 16:30:00,352667.52,355607.39000000025
Buy,81,4353.92,2021-11-21 16:30:00,352667.52,2939.870000000228
Sell,81,4411.54,2021-11-21 16:45:00,357334.74,360274.6100000002
Buy,81,4411.54,2021-11-21 16:45:00,357334.74,2939.870000000228
Sell,81,4386.2,2021-11-21 17:00:00,355282.2,358222.07000000024
Buy,81,4386.2,2021-11-21 17:00:00,355282.2,2939.870000000228
Sell,81,4383.02,2021-11-21 17:15:00,355024.62000000005,357964.4900000003
Buy,81,4383.02,2021-11-21 17:15:00,355024.62000000005,2939.870000000228
Sell,81,4379.79,2021-11-21 17:30:00,354762.99,357702.8600000002
Buy,81,4379.79,2021-11-21 17:30:00,354762.99,2939.870000000228
Sell,81,4374.1,2021-11-21 17:45:00,354302.10000000003,357241.97000000026
Buy,81,4374.1,2021-11-21 17:45:00,354302.10000000003,2939.870000000228
Sell,81,4371.0,2021-11-21 18:00:00,354051.0,356990.8700000002
Buy,81,4371.0,2021-11-21 18:00:00,354051.0,2939.870000000228
Sell,81,4361.53,2021-11-21 18:15:00,353283.93,356223.8000000002
Buy,81,4361.53,2021-11-21 18:15:00,353283.93,2939.870000000228
Sell,81,4368.89,2021-11-21 18:30:00,353880.09,356819.96000000025
Buy,81,4368.89,2021-11-21 18:30:00,353880.09,2939.870000000228
Sell,81,4360.22,2021-11-21 18:45:00,353177.82,356117.69000000024
Buy,81,4360.22,2021-11-21 18:45:00,353177.82,2939.870000000228
Sell,81,4349.8,2021-11-21 19:00:00,352333.8,355273.6700000002
Buy,81,4349.8,2021-11-21 19:00:00,352333.8,2939.870000000228
Sell,81,4350.69,2021-11-21 19:15:00,352405.88999999996,355345.7600000002
Buy,81,4350.69,2021-11-21 19:15:00,352405.88999999996,2939.870000000228
Sell,81,4351.46,2021-11-21 19:30:00,352468.26,355408.13000000024
Buy,81,4351.46,2021-11-21 19:30:00,352468.26,2939.870000000228
Sell,81,4346.09,2021-11-21 19:45:00,352033.29000000004,354973.16000000027
Buy,81,4346.09,2021-11-21 19:45:00,352033.29000000004,2939.870000000228
Sell,81,4354.12,2021-11-21 20:00:00,352683.72,355623.5900000002
Buy,81,4354.12,2021-11-21 20:00:00,352683.72,2939.870000000228
Sell,81,4361.08,2021-11-21 20:15:00,353247.48,356187.3500000002
Buy,81,4361.08,2021-11-21 20:15:00,353247.48,2939.870000000228
Sell,81,4373.09,2021-11-21 20:30:00,354220.29000000004,357160.16000000027
Buy,81,4373.09,2021-11-21 20:30:00,354220.29000000004,2939.870000000228
Sell,81,4384.17,2021-11-21 20:45:00,355117.77,358057.64000000025
Buy,81,4384.17,2021-11-21 20:45:00,355117.77,2939.870000000228
Sell,81,4372.81,2021-11-21 21:00:00,354197.61000000004,357137.4800000003
Buy,81,4372.81,2021-11-21 21:00:00,354197.61000000004,2939.870000000228
Sell,81,4383.97,2021-11-21 21:15:00,355101.57,358041.44000000024
Buy,81,4383.97,2021-11-21 21:15:00,355101.57,2939.870000000228
Sell,81,4377.12,2021-11-21 21:30:00,354546.72,357486.5900000002
Buy,81,4377.12,2021-11-21 21:30:00,354546.72,2939.870000000228
Sell,81,4363.58,2021-11-21 21:45:00,353449.98,356389.8500000002
Buy,81,4363.58,2021-11-21 21:45:00,353449.98,2939.870000000228
Sell,81,4359.13,2021-11-21 22:00:00,353089.53,356029.40000000026
Buy,81,4359.13,2021-11-21 22:00:00,353089.53,2939.870000000228
Sell,81,4342.61,2021-11-21 22:15:00,351751.41,354691.2800000002
Buy,81,4342.61,2021-11-21 22:15:00,351751.41,2939.870000000228
Sell,81,4308.37,2021-11-21 22:30:00,348977.97,351917.8400000002
Buy,81,4308.37,2021-11-21 22:30:00,348977.97,2939.870000000228
Sell,81,4315.66,2021-11-21 22:45:00,349568.45999999996,352508.3300000002
Buy,81,4315.66,2021-11-21 22:45:00,349568.45999999996,2939.870000000228
Sell,81,4319.05,2021-11-21 23:00:00,349843.05,352782.9200000002
Buy,81,4319.05,2021-11-21 23:00:00,349843.05,2939.870000000228
Sell,81,4333.74,2021-11-21 23:15:00,351032.94,353972.81000000023
Buy,81,4333.74,2021-11-21 23:15:00,351032.94,2939.870000000228
Sell,81,4316.9,2021-11-21 23:30:00,349668.89999999997,352608.7700000002
Buy,81,4316.9,2021-11-21 23:30:00,349668.89999999997,2939.870000000228
Sell,81,4259.23,2021-11-21 23:45:00,344997.62999999995,347937.5000000002
Buy,81,4259.23,2021-11-21 23:45:00,344997.62999999995,2939.870000000228
Sell,81,4234.35,2021-11-22 00:15:00,342982.35000000003,345922.22000000026
Buy,81,4234.35,2021-11-22 00:15:00,342982.35000000003,2939.870000000228
Sell,81,4226.81,2021-11-22 00:30:00,342371.61000000004,345311.4800000003
Buy,81,4226.81,2021-11-22 00:30:00,342371.61000000004,2939.870000000228
Sell,81,4230.39,2021-11-22 00:45:00,342661.59,345601.46000000025
Buy,81,4230.39,2021-11-22 00:45:00,342661.59,2939.870000000228
Sell,81,4217.5,2021-11-22 01:00:00,341617.5,344557.3700000002
Buy,81,4217.5,2021-11-22 01:00:00,341617.5,2939.870000000228
Sell,81,4203.72,2021-11-22 01:15:00,340501.32,343441.19000000024
Buy,81,4203.72,2021-11-22 01:15:00,340501.32,2939.870000000228
Sell,81,4215.01,2021-11-22 01:30:00,341415.81,344355.6800000002
Buy,81,4215.01,2021-11-22 01:30:00,341415.81,2939.870000000228
Sell,81,4213.43,2021-11-22 01:45:00,341287.83,344227.70000000024
Buy,81,4213.43,2021-11-22 01:45:00,341287.83,2939.870000000228
Sell,81,4187.76,2021-11-22 02:00:00,339208.56,342148.4300000002
Buy,81,4187.76,2021-11-22 02:00:00,339208.56,2939.870000000228
Sell,81,4171.87,2021-11-22 02:15:00,337921.47,340861.3400000002
Buy,81,4171.87,2021-11-22 02:15:00,337921.47,2939.870000000228
Sell,81,4198.14,2021-11-22 02:30:00,340049.34,342989.21000000025
Buy,81,4198.14,2021-11-22 02:30:00,340049.34,2939.870000000228
Sell,81,4189.91,2021-11-22 02:45:00,339382.70999999996,342322.5800000002
Buy,81,4189.91,2021-11-22 02:45:00,339382.70999999996,2939.870000000228
Sell,81,4174.49,2021-11-22 03:15:00,338133.69,341073.56000000023
Buy,81,4174.49,2021-11-22 03:15:00,338133.69,2939.870000000228
Sell,81,4182.62,2021-11-22 03:30:00,338792.22,341732.0900000002
Buy,81,4182.62,2021-11-22 03:30:00,338792.22,2939.870000000228
Sell,81,4167.33,2021-11-22 03:45:00,337553.73,340493.6000000002
Buy,81,4167.33,2021-11-22 03:45:00,337553.73,2939.870000000228
Sell,81,4182.14,2021-11-22 04:00:00,338753.34,341693.21000000025
Buy,81,4182.14,2021-11-22 04:00:00,338753.34,2939.870000000228
Sell,81,4177.76,2021-11-22 04:15:00,338398.56,341338.4300000002
Buy,81,4177.76,2021-11-22 04:15:00,338398.56,2939.870000000228
Sell,81,4166.13,2021-11-22 04:30:00,337456.53,340396.40000000026
Buy,81,4166.13,2021-11-22 04:30:00,337456.53,2939.870000000228
Sell,81,4155.62,2021-11-22 04:45:00,336605.22,339545.0900000002
Buy,81,4155.62,2021-11-22 04:45:00,336605.22,2939.870000000228
Sell,81,4148.99,2021-11-22 05:00:00,336068.19,339008.06000000023
Buy,81,4148.99,2021-11-22 05:00:00,336068.19,2939.870000000228
Sell,81,4155.99,2021-11-22 05:15:00,336635.19,339575.06000000023
Buy,81,4155.99,2021-11-22 05:15:00,336635.19,2939.870000000228
Sell,81,4166.14,2021-11-22 05:30:00,337457.34,340397.21000000025
Buy,81,4166.14,2021-11-22 05:30:00,337457.34,2939.870000000228
Sell,81,4184.72,2021-11-22 05:45:00,338962.32,341902.19000000024
Buy,81,4184.72,2021-11-22 05:45:00,338962.32,2939.870000000228
Sell,81,4184.1,2021-11-22 06:00:00,338912.10000000003,341851.97000000026
Buy,81,4184.1,2021-11-22 06:00:00,338912.10000000003,2939.870000000228
Sell,81,4168.36,2021-11-22 06:15:00,337637.16,340577.0300000002
Buy,81,4168.36,2021-11-22 06:15:00,337637.16,2939.870000000228
Sell,81,4169.11,2021-11-22 06:30:00,337697.91,340637.7800000002
Buy,81,4169.11,2021-11-22 06:30:00,337697.91,2939.870000000228
Sell,81,4179.18,2021-11-22 06:45:00,338513.58,341453.45000000024
Buy,81,4179.18,2021-11-22 06:45:00,338513.58,2939.870000000228
Sell,81,4195.95,2021-11-22 07:00:00,339871.95,342811.82000000024
Buy,81,4195.95,2021-11-22 07:00:00,339871.95,2939.870000000228
Sell,81,4214.14,2021-11-22 07:15:00,341345.34,344285.21000000025
Buy,81,4214.14,2021-11-22 07:15:00,341345.34,2939.870000000228
Sell,81,4200.29,2021-11-22 07:30:00,340223.49,343163.3600000002
Buy,81,4200.29,2021-11-22 07:30:00,340223.49,2939.870000000228
Sell,81,4188.65,2021-11-22 07:45:00,339280.64999999997,342220.5200000002
Buy,81,4188.65,2021-11-22 07:45:00,339280.64999999997,2939.870000000228
Sell,81,4190.61,2021-11-22 08:00:00,339439.41,342379.2800000002
Buy,81,4190.61,2021-11-22 08:00:00,339439.41,2939.870000000228
Sell,81,4208.59,2021-11-22 08:15:00,340895.79000000004,343835.66000000027
Buy,81,4208.59,2021-11-22 08:15:00,340895.79000000004,2939.870000000228
Sell,81,4199.6,2021-11-22 08:30:00,340167.60000000003,343107.47000000026
Buy,81,4199.6,2021-11-22 08:30:00,340167.60000000003,2939.870000000228
Sell,81,4196.98,2021-11-22 08:45:00,339955.37999999995,342895.2500000002
Buy,81,4196.98,2021-11-22 08:45:00,339955.37999999995,2939.870000000228
Sell,81,4227.21,2021-11-22 09:00:00,342404.01,345343.88000000024
Buy,81,4227.21,2021-11-22 09:00:00,342404.01,2939.870000000228
Sell,81,4214.55,2021-11-22 09:15:00,341378.55,344318.4200000002
Buy,81,4214.55,2021-11-22 09:15:00,341378.55,2939.870000000228
Sell,81,4205.3,2021-11-22 09:30:00,340629.3,343569.1700000002
Buy,81,4205.3,2021-11-22 09:30:00,340629.3,2939.870000000228
Sell,81,4189.33,2021-11-22 09:45:00,339335.73,342275.6000000002
Buy,81,4189.33,2021-11-22 09:45:00,339335.73,2939.870000000228
Sell,81,4192.81,2021-11-22 10:00:00,339617.61000000004,342557.4800000003
Buy,81,4192.81,2021-11-22 10:00:00,339617.61000000004,2939.870000000228
Sell,81,4189.84,2021-11-22 10:15:00,339377.04000000004,342316.91000000027
Buy,81,4189.84,2021-11-22 10:15:00,339377.04000000004,2939.870000000228
Sell,81,4193.12,2021-11-22 10:30:00,339642.72,342582.5900000002
Buy,81,4193.12,2021-11-22 10:30:00,339642.72,2939.870000000228
Sell,81,4205.48,2021-11-22 10:45:00,340643.87999999995,343583.7500000002
Buy,81,4205.48,2021-11-22 10:45:00,340643.87999999995,2939.870000000228
Sell,81,4208.13,2021-11-22 11:00:00,340858.53,343798.40000000026
Buy,81,4208.13,2021-11-22 11:00:00,340858.53,2939.870000000228
Sell,81,4198.95,2021-11-22 11:15:00,340114.95,343054.82000000024
Buy,81,4198.95,2021-11-22 11:15:00,340114.95,2939.870000000228
Sell,81,4194.62,2021-11-22 11:30:00,339764.22,342704.0900000002
Buy,81,4194.62,2021-11-22 11:30:00,339764.22,2939.870000000228
Sell,81,4173.25,2021-11-22 11:45:00,338033.25,340973.1200000002
Buy,81,4173.25,2021-11-22 11:45:00,338033.25,2939.870000000228
Sell,81,4173.16,2021-11-22 12:00:00,338025.95999999996,340965.8300000002
Buy,81,4173.16,2021-11-22 12:00:00,338025.95999999996,2939.870000000228
Sell,81,4210.51,2021-11-22 12:15:00,341051.31,343991.1800000002
Buy,81,4210.51,2021-11-22 12:15:00,341051.31,2939.870000000228
Sell,81,4197.1,2021-11-22 12:30:00,339965.10000000003,342904.97000000026
Buy,81,4197.1,2021-11-22 12:30:00,339965.10000000003,2939.870000000228
Sell,81,4178.77,2021-11-22 12:45:00,338480.37000000005,341420.2400000003
Buy,81,4178.77,2021-11-22 12:45:00,338480.37000000005,2939.870000000228
Sell,81,4139.75,2021-11-22 13:00:00,335319.75,338259.6200000002
Buy,81,4139.75,2021-11-22 13:00:00,335319.75,2939.870000000228
Sell,81,4176.7,2021-11-22 13:15:00,338312.7,341252.57000000024
Buy,81,4176.7,2021-11-22 13:15:00,338312.7,2939.870000000228
Sell,81,4288.69,2021-11-22 13:30:00,347383.88999999996,350323.7600000002
Buy,81,4288.69,2021-11-22 13:30:00,347383.88999999996,2939.870000000228
Sell,81,4278.98,2021-11-22 13:45:00,346597.37999999995,349537.2500000002
Buy,81,4278.98,2021-11-22 13:45:00,346597.37999999995,2939.870000000228
Sell,81,4287.81,2021-11-22 14:00:00,347312.61000000004,350252.4800000003
Buy,81,4287.81,2021-11-22 14:00:00,347312.61000000004,2939.870000000228
Sell,81,4247.53,2021-11-22 14:15:00,344049.93,346989.8000000002
Buy,81,4247.53,2021-11-22 14:15:00,344049.93,2939.870000000228
Sell,81,4246.62,2021-11-22 14:30:00,343976.22,346916.0900000002
Buy,81,4246.62,2021-11-22 14:30:00,343976.22,2939.870000000228
Sell,81,4242.24,2021-11-22 14:45:00,343621.44,346561.31000000023
Buy,81,4242.24,2021-11-22 14:45:00,343621.44,2939.870000000228
Sell,81,4242.6,2021-11-22 15:00:00,343650.60000000003,346590.47000000026
Buy,81,4242.6,2021-11-22 15:00:00,343650.60000000003,2939.870000000228
Sell,81,4234.34,2021-11-22 15:15:00,342981.54000000004,345921.41000000027
Buy,81,4234.34,2021-11-22 15:15:00,342981.54000000004,2939.870000000228
Sell,81,4235.0,2021-11-22 15:30:00,343035.0,345974.8700000002
Buy,81,4235.0,2021-11-22 15:30:00,343035.0,2939.870000000228
Sell,81,4235.9,2021-11-22 15:45:00,343107.89999999997,346047.7700000002
Buy,81,4235.9,2021-11-22 15:45:00,343107.89999999997,2939.870000000228
Sell,81,4218.28,2021-11-22 16:00:00,341680.68,344620.5500000002
Buy,81,4218.28,2021-11-22 16:00:00,341680.68,2939.870000000228
Sell,81,4228.9,2021-11-22 16:15:00,342540.89999999997,345480.7700000002
Buy,81,4228.9,2021-11-22 16:15:00,342540.89999999997,2939.870000000228
Sell,81,4240.07,2021-11-22 16:30:00,343445.67,346385.5400000002
Buy,81,4240.07,2021-11-22 16:30:00,343445.67,2939.870000000228
Sell,81,4232.01,2021-11-22 16:45:00,342792.81,345732.6800000002
Buy,81,4232.01,2021-11-22 16:45:00,342792.81,2939.870000000228
Sell,81,4226.13,2021-11-22 17:00:00,342316.53,345256.40000000026
Buy,81,4226.13,2021-11-22 17:00:00,342316.53,2939.870000000228
Sell,81,4213.42,2021-11-22 17:15:00,341287.02,344226.89000000025
Buy,81,4213.42,2021-11-22 17:15:00,341287.02,2939.870000000228
Sell,81,4194.39,2021-11-22 17:30:00,339745.59,342685.46000000025
Buy,81,4194.39,2021-11-22 17:30:00,339745.59,2939.870000000228
Sell,81,4209.19,2021-11-22 17:45:00,340944.38999999996,343884.2600000002
Buy,81,4209.19,2021-11-22 17:45:00,340944.38999999996,2939.870000000228
Sell,81,4201.75,2021-11-22 18:00:00,340341.75,343281.6200000002
Buy,81,4201.75,2021-11-22 18:00:00,340341.75,2939.870000000228
Sell,81,4201.75,2021-11-22 18:00:00,340341.75,343281.6200000002
